id,bastard,bitch,crap,cunt,damn,fuck,shit,total
377062,2,1,2,0,6,1,30,42
1189340,1,10,0,0,7,4,18,40
120828,0,3,1,0,3,1,13,21
338013,0,1,5,0,7,30,18,61
460989,28,1,1,1,1,46,8,86
1114277,0,0,0,0,0,5,0,5
363771,0,0,0,0,0,0,0,0
460745,0,4,7,0,4,2,9,26
1270761,0,0,0,0,0,0,0,0
1197624,0,4,0,0,3,46,11,64
138097,0,0,0,0,2,0,2,4
221218,2,3,6,0,2,0,3,16
473705,0,1,2,0,2,3,17,25
1201167,0,8,0,0,3,175,69,255
139362,0,0,0,0,1,39,7,47
149691,1,0,0,0,4,0,3,8
765120,3,3,1,0,6,2,3,18
1646971,0,0,0,0,0,0,0,0
286716,0,0,1,0,5,0,2,8
947798,0,0,0,0,0,0,0,0
202402,1,2,1,0,4,0,5,13
1210042,2,20,0,0,9,283,93,407
2017038,0,0,0,0,0,1,0,1
2948356,0,0,0,0,0,0,0,0
139809,0,2,1,0,1,10,5,19
1211837,0,0,0,0,0,0,3,3
4385888,0,0,0,0,0,7,5,12
118623,0,0,0,0,0,0,0,0
858479,0,2,1,0,0,7,9,19
1714206,0,0,0,0,4,26,17,47
343660,1,3,4,0,4,0,10,22
268397,0,0,0,0,0,0,0,0
1758795,0,7,1,0,0,42,31,81
858486,0,0,1,0,1,0,0,2
1129445,0,0,0,0,3,0,0,3
138524,1,7,0,0,9,1,5,23
206314,0,5,0,0,16,19,21,61
1972571,2,0,1,0,0,13,0,16
317219,0,0,1,0,0,0,0,1
493430,3,1,2,0,8,199,58,271
884328,0,0,0,0,6,0,18,24
120586,1,9,3,0,13,182,56,264
1229238,0,0,1,0,4,0,3,8
1655460,1,0,1,0,5,36,20,63
1355683,0,0,0,0,7,241,24,272
449089,0,1,2,0,2,0,0,5
1273678,0,0,0,0,0,0,0,0
267891,1,1,3,0,1,1,2,9
2058673,0,1,0,0,2,1,16,20
138487,0,0,0,6,0,74,18,98
467406,1,3,0,0,2,0,10,16
266543,0,0,0,0,0,0,0,0
389790,0,0,0,0,0,0,0,0
2091473,0,1,0,0,5,25,21,52
250797,0,0,0,0,2,13,14,29
990407,2,6,5,0,5,1,37,56
814075,1,0,1,0,1,3,2,8
274812,0,0,0,0,1,4,1,6
166276,2,2,1,0,6,0,1,12
3076658,0,3,0,0,4,2,10,19
1559547,0,6,0,0,10,0,7,23
1621444,0,0,0,0,6,1,0,7
168501,1,9,0,0,26,26,36,98
349205,0,0,0,0,1,0,0,1
5052448,1,5,0,0,3,43,36,88
337917,0,0,0,0,1,0,0,1
145487,0,0,4,0,0,0,0,4
130018,2,3,0,0,12,21,25,63
2870756,0,0,0,0,3,0,0,3
891527,0,0,0,0,1,0,12,13
120784,3,6,1,0,5,26,14,55
3007512,5,0,0,0,3,0,0,8
1234719,1,7,0,0,5,1,39,53
1881002,0,0,2,0,3,0,2,7
361748,0,2,1,0,15,20,4,42
436339,0,0,0,0,0,0,0,0
3760922,0,0,0,0,0,0,0,0
1753549,0,1,0,0,9,0,1,11
1564349,0,0,1,0,0,0,0,1
279113,0,0,0,0,3,6,4,13
1192628,0,0,0,0,3,0,0,3
346491,5,2,1,0,8,0,0,16
1742336,0,1,0,0,0,65,26,92
1800246,0,0,0,0,1,75,44,120
2397535,2,5,0,0,6,11,11,35
220099,0,0,0,0,0,0,0,0
4846340,1,0,0,0,13,0,0,14
327084,0,0,2,0,0,0,0,2
179626,0,2,1,0,11,48,22,84
1625346,0,2,2,0,1,9,6,20
215750,2,1,0,0,0,1,4,8
250224,0,4,0,0,13,1,17,35
295178,7,1,2,0,2,4,3,19
3731562,0,3,1,0,3,3,9,19
453562,2,4,1,0,5,0,1,13
974554,0,0,0,0,1,12,0,13
1598642,0,0,0,0,3,1,2,6
244244,0,3,0,0,2,22,21,48
120008,0,0,0,0,2,4,5,11
832266,1,2,1,0,0,0,4,8
293508,0,0,3,0,4,0,0,7
448157,1,3,0,0,3,1,8,16
1547234,3,3,1,0,22,1,54,84
3850590,1,3,6,0,5,2,9,26
2258345,0,1,0,0,0,3,1,5
1512235,1,4,1,1,3,68,7,85
305224,1,4,4,0,2,1,18,30
1967545,0,0,0,0,1,0,0,1
120746,0,0,0,0,4,0,0,4
122151,3,12,0,0,8,22,40,85
1125849,0,2,1,0,19,72,22,116
145653,1,2,3,0,3,2,7,18
1716772,1,2,1,2,0,86,29,121
120791,1,2,0,0,5,0,4,12
1297919,4,0,0,4,0,68,14,90
1423995,1,5,0,1,12,60,39,118
381681,0,2,1,0,1,5,8,17
1204340,8,0,0,13,0,122,7,150
206275,0,9,1,0,7,1,42,60
481141,0,0,0,0,1,0,0,1
1235189,0,0,0,0,1,1,3,5
1206543,1,7,0,1,8,101,26,144
457513,0,0,2,0,2,0,0,4
118971,0,3,0,0,10,44,13,70
2404311,2,3,1,0,2,38,9,55
1397514,0,0,1,0,0,0,0,1
260866,0,4,0,0,3,17,4,28
2034031,0,0,1,0,0,21,19,41
1663662,3,5,3,0,6,0,3,20
2404463,0,12,6,1,15,146,94,274
1381404,0,0,0,0,7,17,17,41
2024544,3,1,0,0,22,0,0,26
878804,0,6,1,0,1,0,1,9
276751,6,0,7,0,0,2,9,24
432348,1,6,0,0,7,88,36,138
1211956,0,3,1,1,3,51,8,67
4034354,0,1,0,0,0,10,24,35
405296,0,3,0,0,0,36,18,57
218922,0,0,0,0,4,0,0,4
449088,0,0,0,0,1,0,0,1
192335,0,0,2,0,1,0,0,3
120587,0,1,2,0,4,0,0,7
3060952,0,1,2,0,6,0,0,9
187738,2,3,0,1,4,27,14,51
942385,5,6,1,0,24,117,72,225
1405365,0,1,4,0,2,46,16,69
337692,3,4,0,2,6,11,13,39
1213012,0,0,2,0,0,0,0,2
472181,0,0,0,0,1,0,0,1
2446042,0,0,0,0,6,7,12,25
130623,0,0,0,0,0,0,0,0
245562,0,6,2,0,25,12,26,71
385752,0,0,1,0,0,0,0,1
276816,1,1,1,0,9,13,8,33
122541,0,0,0,0,4,0,0,4
1245526,0,0,0,0,0,0,0,0
145531,1,0,0,0,2,5,2,10
1622979,0,1,0,0,0,5,12,18
1083452,0,0,2,0,0,0,1,3
804461,3,4,0,0,6,97,11,121
119528,4,1,2,0,4,0,5,16
1711425,0,17,0,0,2,216,78,313
1790885,0,1,0,0,2,53,11,67
221027,0,4,1,0,2,92,22,121
815236,0,7,2,0,11,53,37,110
1424432,0,1,0,0,0,6,1,8
2132285,0,13,1,1,6,35,22,78
810819,0,0,0,0,0,0,0,0
119925,3,0,0,0,13,1,9,26
762114,0,0,0,0,2,0,2,4
976222,0,0,0,0,0,0,0,0
402894,1,0,0,0,4,0,0,5
317740,2,1,1,0,7,1,8,20
211443,3,3,1,0,9,3,21,40
449467,0,0,0,0,1,6,1,8
1029120,0,0,0,0,5,0,3,8
120632,0,0,3,0,2,0,8,13
1262416,2,3,5,0,12,8,3,33
977855,0,2,2,0,2,2,10,18
364751,1,0,1,0,13,1,20,36
1226240,0,0,0,0,1,11,8,20
320661,2,0,0,0,0,0,0,2
120815,4,10,1,0,8,17,15,55
822854,0,4,0,0,5,12,8,29
780608,0,0,2,0,3,45,21,71
1204977,0,1,0,0,2,0,2,5
2281587,0,0,0,0,0,0,0,0
177971,1,3,3,0,12,2,11,32
1321511,0,7,1,0,7,46,7,68
325055,1,1,0,0,1,8,4,15
4501244,0,3,2,0,4,78,27,114
1331064,1,0,1,0,0,0,3,5
1204975,2,2,3,0,14,1,12,34
362478,0,0,0,0,2,1,0,3
349825,1,0,2,0,4,0,0,7
358082,0,0,5,0,0,0,0,5
297181,1,7,2,0,6,0,43,59
3530002,0,3,0,3,4,157,72,239
265459,0,0,0,0,1,11,3,15
418819,5,3,0,0,4,42,13,67
395972,0,11,8,1,9,16,8,53
465602,3,5,1,0,9,15,2,35
2101473,1,0,1,0,0,0,0,2
421054,0,17,0,1,14,122,20,174
814314,0,1,0,0,3,0,3,7
1680114,5,1,1,3,0,123,16,149
414951,0,4,0,1,0,30,6,41
1340138,0,1,1,0,6,1,7,16
1396218,0,0,0,0,1,0,0,1
400717,0,0,1,0,0,0,0,1
217756,3,8,7,0,13,1,12,44
404203,1,2,0,0,5,15,7,30
3874544,0,0,0,0,0,0,0,0
120630,0,0,0,0,0,0,0,0
1951181,0,4,0,0,0,8,2,14
2091935,0,10,0,1,2,111,21,145
1772341,0,0,0,0,0,0,0,0
190865,2,0,1,0,6,1,3,13
119099,0,2,0,0,4,23,14,43
844286,1,2,0,0,7,3,9,22
1399103,1,3,2,0,2,0,10,18
371606,0,0,2,0,0,0,0,2
255798,0,1,0,0,1,0,9,11
146984,0,1,0,0,12,0,2,15
479997,0,2,0,0,1,0,1,4
362120,0,5,1,0,8,2,12,28
1135084,3,9,0,0,26,0,60,98
268380,0,0,0,0,0,0,0,0
127349,0,2,1,0,6,22,7,38
1424381,0,4,0,0,9,46,26,85
1866249,0,1,1,0,2,1,9,14
2024432,0,7,2,0,8,40,53,110
1440161,1,2,0,0,0,1,11,15
2057392,0,0,0,0,2,8,6,16
266391,3,3,1,0,13,0,3,23
2872750,0,0,0,0,0,0,0,0
2265398,0,0,1,0,4,51,11,67
1645089,0,0,4,0,0,0,5,9
120591,0,3,1,0,10,1,6,21
1731697,0,0,0,2,2,12,3,19
1198138,1,5,0,0,4,1,3,14
119304,3,1,2,0,18,0,6,30
377471,0,12,1,0,27,1,39,80
364343,2,2,0,0,2,0,3,9
1243974,0,1,2,0,0,1,6,10
426459,3,1,3,0,20,76,36,139
2473602,0,1,0,0,5,2,12,20
437232,0,0,0,0,0,0,2,2
174856,2,7,0,0,4,26,29,68
118998,0,0,1,0,1,0,0,2
1631867,2,7,0,0,1,0,5,15
4972582,0,1,0,0,0,2,2,5
3464902,0,0,0,0,0,4,0,4
3179568,0,5,1,0,1,18,6,31
319343,0,0,2,0,1,0,0,3
209144,1,0,2,1,0,70,23,97
1204342,0,0,0,0,0,0,0,0
280760,0,2,1,1,2,38,6,50
480249,0,0,0,0,3,0,0,3
120793,0,0,0,0,1,2,2,5
120787,1,0,0,0,3,7,1,12
854678,0,0,2,0,0,0,1,3
452694,0,1,0,0,2,0,7,10
848537,0,0,0,0,0,0,0,0
2910274,0,2,1,1,2,30,21,57
118556,5,2,1,0,6,0,3,17
426883,1,50,1,1,9,420,72,554
1650043,0,0,0,0,0,0,0,0
161081,0,1,0,0,1,1,4,7
333780,0,0,2,0,3,0,0,5
120036,3,5,20,0,49,0,1,78
460829,0,0,0,0,5,35,22,62
481369,0,4,1,0,2,8,6,21
1020072,2,2,0,0,12,2,7,25
2515034,1,1,0,0,2,43,11,58
491152,0,0,1,0,2,1,9,13
458352,0,0,1,0,1,0,6,8
339291,0,0,0,0,1,0,0,1
1259521,0,1,0,0,3,49,13,66
1408253,3,13,0,0,27,1,66,110
1179891,0,4,0,0,7,46,18,75
128442,1,7,5,0,4,129,24,170
1670345,0,0,2,0,7,1,17,27
418763,1,7,0,0,9,293,70,380
290002,1,0,2,0,1,0,8,12
366780,0,0,0,0,0,0,0,0
286106,1,1,2,0,1,0,3,8
210616,1,5,0,0,1,1,7,15
1588334,0,0,1,0,4,43,15,63
1687901,4,0,0,0,0,0,0,4
453548,0,2,1,0,7,40,13,63
2592614,0,1,0,0,2,0,0,3
297037,0,4,0,0,22,1,16,43
348333,3,29,1,1,14,135,34,217
241303,1,2,0,0,5,0,0,8
1398426,0,22,2,0,36,364,250,674
279111,0,0,0,0,7,0,0,7
324216,0,1,1,0,20,39,24,85
368008,0,0,0,0,5,2,6,13
119891,1,0,1,0,1,5,3,11
1560139,1,0,0,0,0,31,15,47
816462,0,0,0,0,0,0,0,0
1742334,2,12,0,1,11,221,53,300
144214,0,7,0,0,5,15,7,34
452681,0,0,0,0,0,0,0,0
119675,0,0,2,0,6,17,28,53
1327773,0,5,1,0,14,1,11,32
457510,0,0,1,0,0,0,0,1
1067106,0,0,2,0,0,0,0,2
204313,1,0,1,0,3,4,0,9
264395,1,6,0,0,9,52,22,90
119488,1,0,1,0,3,21,11,37
1232829,1,0,0,0,8,0,0,9
443559,0,1,0,0,4,40,6,51
393735,0,0,0,0,0,0,0,0
118972,4,0,1,2,4,17,1,29
1571222,0,0,0,0,0,1,0,1
804516,0,0,0,1,2,18,7,28
335119,0,0,0,0,0,0,0,0
486822,4,2,1,0,1,1,36,45
859163,2,2,2,0,2,0,0,8
2262227,0,0,0,0,0,0,0,0
360130,1,3,1,0,14,1,5,25
369672,1,1,0,0,32,24,19,77
1001526,0,0,0,0,0,0,0,0
368578,0,0,0,0,3,0,0,3
2702724,0,12,0,1,2,36,24,75
1742650,0,0,0,0,1,0,12,13
1740047,0,0,0,3,0,12,3,18
817230,0,1,3,0,5,0,3,12
1245492,1,5,0,1,23,336,134,500
327247,1,2,0,0,3,0,12,18
1657507,1,4,0,0,4,6,7,22
4094724,0,11,1,2,8,46,14,82
1349451,0,5,0,1,1,13,8,28
2581244,1,2,0,0,1,56,14,74
970452,0,0,0,0,5,0,0,5
1980929,0,1,0,0,3,53,32,89
1139668,0,1,0,0,0,1,5,7
405336,2,19,0,0,1,68,27,117
2316411,0,0,0,0,0,16,3,19
765446,0,0,0,0,0,0,0,0
1714210,2,2,0,4,1,90,8,107
209958,0,3,1,1,2,20,3,30
1814621,0,1,1,0,9,1,4,16
198021,0,0,1,0,6,1,10,18
3235888,0,0,0,0,0,11,6,17
1602472,0,10,4,1,0,27,19,61
1276104,1,0,0,0,12,33,26,72
119517,0,3,0,2,3,68,26,102
265666,1,4,1,0,17,3,9,35
844708,0,6,0,1,5,40,14,66
1049402,0,0,1,3,0,6,3,13
120382,0,1,1,0,4,0,2,8
1790886,0,3,5,1,13,31,12,65
258068,1,0,0,0,1,2,3,7
175142,2,9,0,0,6,21,32,70
399146,0,10,2,0,8,15,16,51
414993,0,0,0,0,3,1,1,5
2357129,0,2,0,0,3,3,14,22
329691,1,8,0,0,11,1,18,39
421082,2,0,1,1,0,79,5,88
120631,2,0,0,0,0,0,1,3
364961,0,0,2,0,7,5,9,23
120157,1,1,1,0,1,2,2,8
2267968,0,0,0,0,0,0,0,0
129167,0,0,5,0,2,0,0,7
2980706,0,0,0,0,0,0,0,0
473075,0,0,1,0,0,0,0,1
345950,0,0,1,0,1,0,0,2
1704573,0,2,1,0,6,1,8,18
1179933,0,1,0,0,1,1,2,5
2884206,0,1,0,0,0,10,5,16
232500,3,1,3,0,6,1,32,46
478134,0,0,0,0,5,0,5,10
1325004,0,0,0,0,2,0,0,2
356910,0,4,1,0,1,1,6,13
119715,2,1,0,0,1,0,0,4
306841,0,0,0,0,0,0,0,0
210945,0,0,1,0,2,0,0,3
278435,0,4,0,0,2,0,2,8
366627,0,0,0,0,3,13,9,25
145734,2,1,1,0,5,18,11,38
120812,0,4,0,0,17,0,39,60
4116284,0,0,0,0,0,0,0,0
219965,1,1,1,0,9,1,9,22
120184,0,0,0,0,5,0,5,10
419294,0,15,0,0,13,30,22,80
822847,0,1,0,0,2,2,1,6
426931,0,0,1,0,7,0,0,8
316465,0,0,2,0,2,0,7,11
762107,2,3,2,0,3,0,13,23
120609,2,15,0,0,8,70,43,138
131704,0,0,1,0,1,0,0,2
169547,1,2,1,1,4,21,8,38
170016,0,1,0,0,0,0,0,1
437800,0,0,0,0,2,0,1,3
456554,0,2,3,0,2,42,30,79
1270798,1,0,0,0,4,1,0,6
305357,0,5,1,0,6,0,1,13
162360,1,0,3,0,7,1,1,13
2692904,6,0,1,2,1,99,14,123
486946,0,5,2,0,12,0,12,31
2005374,0,16,0,1,7,75,21,120
2567712,1,0,0,47,0,337,15,400
3079380,0,3,0,1,14,118,35,171
790636,0,7,2,0,23,121,47,200
1231277,0,2,1,0,2,5,8,18
265662,0,0,5,0,4,0,0,9
470752,1,0,0,0,2,22,6,31
227445,0,1,1,0,0,41,14,57
831387,0,0,1,0,1,0,6,8
1219289,0,1,5,0,0,6,8,20
1000774,0,0,0,0,0,0,4,4
273799,0,0,0,0,0,0,0,0
289635,6,0,0,0,1,4,0,11
1130884,0,2,0,0,18,19,11,50
811080,0,0,0,0,1,0,1,2
313737,0,1,0,0,1,0,0,2
986263,1,1,2,0,2,0,2,8
366551,0,4,0,0,2,60,80,146
2058107,2,0,0,0,0,0,0,2
1611224,0,2,0,0,2,1,0,5
1142433,0,3,7,0,7,1,15,33
1109624,0,0,0,0,0,0,0,0
3748528,0,0,0,0,0,0,0,0
286499,1,5,0,0,1,0,7,14
255819,1,25,0,0,14,99,73,212
335121,0,0,2,0,10,0,4,16
1656190,2,5,0,0,3,9,10,29
1175506,0,1,0,0,11,5,3,20
1441326,0,0,0,0,3,19,1,23
1242460,0,0,0,0,0,0,0,0
1065073,0,8,5,0,7,39,20,79
960731,0,0,1,0,0,0,0,1
312549,3,3,1,6,0,36,11,60
1823664,0,0,2,0,2,0,0,4
2179136,0,6,1,0,12,112,44,175
288477,0,5,0,0,7,19,17,48
180093,1,2,0,0,2,30,19,54
382628,0,3,0,0,4,2,3,12
416212,0,1,0,0,13,0,3,17
2279373,0,0,0,0,0,0,0,0
1712261,6,6,1,0,3,40,34,90
264150,0,0,0,0,3,0,6,9
186151,1,2,0,0,7,0,7,17
1564367,0,0,3,0,0,0,3,6
2199571,0,2,0,0,5,35,28,70
131857,0,12,2,0,4,15,24,57
3450650,0,0,2,0,0,0,0,2
120769,9,12,0,0,47,0,12,80
1959490,0,0,0,0,4,0,0,4
120755,3,3,0,0,4,0,2,12
251114,3,0,1,0,4,9,8,25
1027718,2,1,2,0,6,2,2,15
2305051,1,4,2,0,1,36,12,56
120741,3,0,2,0,1,1,2,9
368794,1,2,3,0,6,17,9,38
1602098,2,1,0,0,1,9,0,13
120032,0,3,0,0,2,9,6,20
265298,0,0,1,0,0,0,0,1
163651,0,3,2,0,5,23,33,66
386117,0,0,0,0,2,0,0,2
120768,1,5,1,0,1,57,23,88
139239,0,4,1,0,8,46,26,85
360486,0,2,0,0,6,1,8,17
119664,1,3,1,0,8,100,55,168
283084,0,0,0,0,0,0,0,0
380599,0,0,0,0,9,0,0,9
119116,2,0,0,0,1,0,4,7
261983,1,1,3,0,4,45,9,63
892767,0,0,0,0,1,56,15,72
376541,4,2,3,3,0,35,4,51
1800241,0,7,0,0,6,133,40,186
435623,0,0,0,0,0,15,4,19
425430,0,1,0,0,5,0,3,9
480271,4,2,2,0,2,0,2,12
1176740,0,1,0,2,6,16,8,33
463854,0,0,0,0,0,32,13,45
1540011,0,0,1,0,3,39,29,72
2126355,0,0,0,0,3,1,12,16
475944,1,3,0,0,4,0,5,13
3099498,0,2,0,0,5,62,37,106
494238,0,0,0,0,1,0,0,1
124718,0,18,0,0,23,59,44,144
423294,0,0,2,0,0,0,0,2
1226681,0,0,0,0,0,17,18,35
1764651,1,0,0,0,1,0,13,15
449059,1,1,1,0,5,30,5,43
359950,0,0,2,0,0,0,1,3
489282,5,4,5,0,9,78,37,138
120595,0,0,0,0,0,0,0,0
1687247,0,0,0,0,0,2,1,3
119314,0,1,0,0,2,0,3,6
367882,0,3,0,0,2,0,0,5
167190,0,0,8,0,8,0,0,16
118750,0,5,0,0,17,31,30,83
1859650,0,0,0,0,4,1,4,9
405469,0,0,0,0,0,0,0,0
765443,0,2,0,0,0,5,1,8
253474,3,1,0,0,2,2,5,13
1129442,1,0,1,0,1,1,4,8
455538,0,5,0,0,0,25,7,37
2334879,1,7,0,0,17,1,27,53
918927,0,0,0,0,1,0,1,2
1212450,6,9,1,0,50,27,30,123
198781,0,0,0,0,0,0,0,0
338216,0,1,0,0,2,0,3,6
1049413,0,0,0,0,0,0,0,0
1091722,3,5,1,0,1,60,26,96
989757,0,1,0,0,2,0,3,6
313911,0,0,1,0,1,0,0,2
816711,2,1,0,0,7,0,10,20
251075,2,2,2,0,14,0,5,25
1509767,1,0,0,0,8,0,2,11
120620,0,1,0,0,5,1,8,15
2294629,0,0,0,0,0,0,0,0
364970,1,1,0,0,1,1,9,13
119937,1,6,4,0,17,3,4,35
1142977,0,0,0,0,0,0,0,0
441773,0,0,0,0,0,0,0,0
414982,0,4,0,0,5,35,25,69
1599348,0,1,0,0,0,1,5,7
1028576,0,0,1,0,0,0,0,1
1142988,0,4,5,0,3,11,12,35
1027862,2,1,4,0,10,1,20,38
970866,1,2,4,0,1,0,11,19
120185,0,0,2,0,1,0,0,3
309593,1,4,2,0,5,22,20,54
964185,2,7,0,0,2,1,3,15
3498820,0,2,1,0,4,0,5,12
119738,0,1,0,0,1,0,2,4
195714,0,0,0,0,4,46,16,66
424880,0,1,1,2,0,62,16,82
433442,0,0,0,0,2,1,1,4
2493486,0,0,0,0,0,0,0,0
1205489,1,21,0,0,11,59,21,113
1234654,0,0,1,0,0,43,16,60
1412386,1,0,2,0,0,1,0,4
2140373,0,0,0,0,2,0,0,2
2205697,0,2,0,0,4,31,13,50
785006,0,0,2,0,0,0,0,2
1441912,0,1,1,0,3,0,0,5
1188729,1,0,0,0,5,35,7,48
460740,1,0,0,0,0,1,4,6
834001,0,0,0,0,0,0,0,0
134119,1,0,0,0,0,4,1,6
3387542,0,0,0,0,3,0,3,6
427392,0,0,0,0,1,0,2,3
257360,1,0,1,0,7,4,0,13
1446714,1,2,0,0,8,1,8,20
297144,0,0,1,0,0,0,0,1
1621045,0,10,1,0,24,1,38,74
1229822,0,0,0,0,0,0,0,0
2034800,0,0,0,0,1,2,1,4
1714203,0,0,2,0,9,21,16,48
1435513,0,0,0,0,3,0,0,3
2692250,0,0,0,0,1,0,0,1
1854564,0,0,0,0,3,0,0,3
1214962,1,6,0,0,1,16,3,27
367089,0,4,0,2,7,24,13,50
363589,0,5,0,0,0,10,8,23
405325,0,1,1,0,0,0,0,2
318649,0,0,3,0,6,0,0,9
479952,0,0,1,0,1,0,0,2
2120120,0,5,1,0,1,0,2,9
285742,0,1,0,0,15,8,14,38
120434,0,0,6,0,2,0,0,8
462396,0,0,2,0,0,0,0,2
388500,0,9,0,0,30,0,5,44
1465522,0,4,6,0,11,30,32,83
401792,15,11,2,0,37,1,4,70
412922,0,0,0,0,1,0,0,1
338348,0,0,0,0,0,0,0,0
2561572,0,26,0,0,9,117,58,210
498399,0,0,1,0,0,74,18,93
455499,0,0,2,0,0,0,0,2
1817273,0,1,0,0,2,159,27,189
3332064,0,0,0,0,1,0,0,1
800039,0,4,1,0,3,47,21,76
359013,0,2,0,1,11,50,12,76
450278,0,7,0,0,3,124,25,159
2316204,0,1,1,0,4,42,18,66
162983,4,2,2,0,7,2,1,18
3315342,0,0,0,0,4,44,31,79
462590,0,0,0,0,3,0,3,6
1921064,1,2,0,0,0,0,0,3
408985,0,1,1,0,7,0,3,12
281322,0,7,1,0,13,49,50,120
159097,0,1,0,0,0,0,1,2
420238,0,0,0,0,0,0,0,0
194218,0,1,3,0,11,22,5,42
119896,0,0,1,0,7,0,13,21
166924,2,0,1,0,1,2,1,7
369339,0,3,1,0,8,22,37,71
377107,0,0,0,0,3,2,5,10
124295,0,0,1,0,1,4,4,10
455857,0,1,0,0,1,0,2,4
381849,1,3,0,0,17,2,7,30
477348,0,2,0,0,6,2,0,10
327056,0,4,0,0,6,69,15,94
844479,0,3,7,0,0,0,1,11
1225822,0,0,2,0,11,6,28,47
1411704,0,0,0,0,0,0,0,0
395169,1,0,0,0,1,1,7,10
438488,1,3,0,0,2,0,4,10
120742,0,3,1,0,7,0,8,19
4005402,0,0,0,1,3,8,5,17
1222817,0,0,1,0,0,0,0,1
Stemmer_Script.py,6,6,6,6,6,6,6,42
1700841,1,5,1,3,5,173,51,239
429591,0,1,0,0,0,0,0,1
164114,0,4,0,0,1,1,9,15
803096,1,0,0,0,0,0,0,1
768212,0,0,0,0,1,0,0,1
120757,0,0,0,0,4,22,26,52
212985,0,0,0,0,2,3,0,5
132347,0,0,0,0,0,0,1,1
1504320,2,0,0,0,4,19,15,40
313443,1,0,0,0,4,0,6,11
151804,1,2,0,0,6,15,23,47
145681,0,3,1,0,10,15,8,37
1860213,1,4,0,1,7,168,50,231
142688,1,2,0,0,1,1,2,7
388139,0,0,0,2,0,114,13,129
1452628,0,0,0,0,7,9,13,29
128445,1,0,1,0,7,9,7,25
119115,9,0,3,0,8,1,1,22
120794,0,0,0,0,0,0,0,0
375063,0,3,2,0,3,78,17,103
431308,1,7,1,0,2,0,7,18
2980648,0,0,0,0,0,0,1,1
120780,0,12,0,0,11,60,46,129
430770,1,2,0,0,4,0,8,15
1135487,0,3,1,0,13,0,7,24
2339741,0,0,0,0,2,0,0,2
1628841,0,3,0,0,7,0,6,16
1234721,0,1,2,0,8,1,10,22
1748179,0,0,2,0,1,12,9,24
1716777,0,0,0,0,1,3,30,34
1872818,1,0,0,0,3,0,1,5
1648179,0,0,1,0,0,0,0,1
1355644,0,1,1,0,3,0,1,6
473488,0,7,3,0,4,263,67,344
1823672,0,1,1,0,4,43,28,77
125439,0,1,4,0,7,1,5,18
290212,0,0,2,0,4,48,9,63
1656186,1,1,4,0,5,4,6,21
406759,0,0,0,0,0,0,1,1
1124039,1,2,0,0,6,5,11,25
323033,1,0,3,0,2,0,2,8
1864288,0,0,1,0,1,27,8,37
120596,0,2,2,0,9,1,9,23
1001508,0,0,2,0,1,1,29,33
1082601,0,6,0,0,4,0,20,30
1114677,0,0,1,0,0,0,0,1
489281,1,0,1,0,14,76,35,127
332658,4,0,0,7,1,152,25,189
1080016,0,0,0,0,1,0,0,1
180052,2,2,1,0,6,0,17,28
119303,0,0,0,0,1,0,0,1
118747,0,2,1,0,2,0,9,14
372532,2,0,2,0,0,0,4,8
829482,1,13,0,0,4,236,95,349
2172934,1,2,0,0,2,2,5,12
234215,0,0,0,0,6,1,13,20
185937,0,0,0,0,3,97,46,146
398712,0,15,0,0,22,142,72,251
120347,1,0,1,0,2,0,0,4
382992,2,3,1,0,7,1,12,26
970468,0,0,0,0,12,0,0,12
378194,3,10,0,1,11,25,12,62
4781612,0,1,1,0,7,138,30,177
1232783,0,17,2,0,2,32,12,65
770703,0,3,0,0,3,22,18,46
1720616,0,0,2,0,1,35,21,59
393109,0,0,4,0,2,0,0,6
962736,0,0,1,0,1,0,0,2
322259,0,2,1,0,20,0,44,67
808510,0,0,0,0,0,0,0,0
2334649,0,19,0,0,7,76,37,139
120390,1,4,0,0,4,12,8,29
881320,3,4,0,0,6,29,30,72
1748227,0,0,0,0,0,31,8,39
2980516,0,0,0,0,1,0,0,1
1742044,0,2,1,0,5,40,31,79
143145,0,0,0,0,1,0,0,1
1781769,0,0,0,0,3,0,0,3
427152,0,0,0,0,0,1,7,8
1034389,0,0,0,0,1,0,1,2
166110,1,6,0,0,19,55,37,118
139414,0,0,0,0,0,0,0,0
1606389,0,0,1,0,2,0,6,9
120623,0,0,1,0,0,0,0,1
357413,1,6,1,0,15,6,6,35
1291570,0,0,3,0,5,12,10,30
2823054,0,16,0,0,15,97,40,168
1723121,0,6,0,0,10,118,35,169
406375,0,0,0,0,0,0,0,0
120179,0,0,0,0,5,0,16,21
328589,1,0,0,0,2,0,5,8
304711,0,0,0,0,5,4,3,12
1430132,0,3,0,0,2,1,4,10
3170832,0,1,0,0,0,12,0,13
233142,0,4,1,0,10,52,23,90
119707,0,0,0,0,1,0,0,1
3521134,0,0,0,0,0,0,0,0
3890160,0,5,0,0,14,67,30,116
181984,0,4,0,0,4,132,42,182
327679,0,0,0,0,0,0,0,0
2170299,1,2,0,0,4,21,13,41
247199,0,1,4,0,1,57,11,74
120804,1,8,0,0,2,11,8,30
2191701,0,0,7,0,10,0,0,17
1220634,0,4,0,0,4,8,7,23
1045772,0,8,2,0,5,60,12,87
3395184,0,4,0,6,6,116,22,154
857265,3,0,0,3,0,20,10,36
418689,0,7,3,0,27,10,22,69
1605630,0,10,1,0,1,55,38,105
120693,1,15,1,0,15,13,31,76
1981115,0,0,0,0,2,0,2,4
430105,3,22,2,0,27,109,102,265
2309961,0,1,1,0,2,20,40,64
120863,0,6,0,0,24,13,7,50
184858,3,3,0,0,11,57,31,105
120888,0,2,1,0,3,1,13,20
318411,1,5,0,0,2,10,1,19
120122,4,0,1,0,1,0,12,18
444653,0,3,0,0,0,6,3,12
137338,0,4,0,0,5,43,22,74
134619,1,4,1,0,1,18,19,44
2679042,1,0,0,0,3,9,5,18
388980,0,0,0,0,2,0,0,2
203019,1,7,0,0,31,16,7,62
296572,0,0,0,0,3,1,9,13
1371150,0,5,4,0,9,24,40,82
787475,0,0,3,0,3,1,10,17
1615147,1,0,0,1,3,79,8,92
119210,1,3,0,0,20,2,7,33
343818,0,1,0,0,6,0,13,20
144117,4,7,0,0,4,239,39,293
386588,0,0,1,0,4,1,2,8
1155076,0,0,0,0,1,0,0,1
1567233,0,0,0,0,0,0,0,0
233469,1,4,1,0,8,4,5,23
492956,0,0,0,0,0,0,0,0
357110,0,1,1,0,0,10,5,17
2387433,0,3,0,0,0,2,8,13
2872718,0,1,1,0,4,54,18,78
162661,0,0,0,0,0,0,0,0
2463288,1,20,1,0,5,45,23,95
1638002,1,0,3,0,1,17,4,26
395251,0,0,0,0,1,0,1,2
432289,0,0,0,0,2,0,19,21
1075417,0,0,0,0,0,0,0,0
202677,0,5,0,2,3,46,6,62
1440129,1,1,1,0,6,0,11,20
382077,0,0,1,0,0,1,0,2
319531,0,0,1,0,1,23,7,32
1587310,0,0,0,0,0,0,0,0
2543164,1,0,0,0,1,1,0,3
981227,1,3,1,0,4,1,10,20
1019452,2,0,3,0,0,18,7,30
1486185,0,0,0,0,0,0,0,0
1078912,0,0,0,0,3,0,0,3
327554,0,0,0,0,0,0,0,0
1636826,0,17,0,1,8,208,82,316
4624424,0,0,0,0,0,0,0,0
1840417,0,0,0,0,2,8,7,17
2938956,0,2,0,0,0,0,12,14
1800741,0,2,2,0,2,0,1,7
1911658,0,0,0,0,0,0,0,0
1612774,0,2,2,0,5,5,8,22
1313104,0,0,0,0,1,0,3,4
2333784,2,2,0,0,13,3,24,44
1939659,0,1,0,0,6,6,15,28
2209418,0,2,1,1,1,37,25,67
1932718,0,4,2,0,7,80,32,125
327597,0,0,1,0,0,0,0,1
1343727,0,8,0,0,2,50,10,70
348150,0,0,1,0,5,0,0,6
1601913,3,6,1,0,6,186,51,253
795461,4,2,2,0,6,1,9,24
2244901,0,1,1,0,3,27,7,39
848557,0,7,1,0,8,73,36,125
409182,0,1,0,0,7,0,1,9
1748122,1,2,0,0,6,0,0,9
259288,0,1,1,0,3,1,0,6
120917,0,0,0,0,0,0,0,0
2395427,2,1,0,0,4,0,1,8
315733,2,3,1,0,9,30,9,54
490204,0,0,0,0,0,0,7,7
2937898,0,0,0,1,0,36,15,52
452637,0,0,0,0,1,0,0,1
2869728,1,1,0,0,4,12,10,28
452623,1,0,0,0,15,0,10,26
3110958,1,0,1,0,2,1,7,12
443706,2,1,2,0,3,15,7,30
307479,0,0,1,0,0,1,5,7
4651520,0,8,2,0,3,69,27,109
219653,1,1,0,0,7,16,4,29
119832,0,1,0,0,2,20,6,29
361925,1,5,3,0,2,0,1,12
200465,5,0,1,2,2,31,18,59
1186830,0,0,0,0,6,0,0,6
300471,1,0,0,0,8,0,4,13
161023,0,0,1,0,16,1,15,33
448134,0,1,0,0,1,11,7,20
1772240,2,0,0,0,13,1,6,22
1120985,0,9,0,1,7,59,16,92
476964,0,9,1,4,4,48,21,87
2717822,0,1,1,0,2,2,2,8
891592,0,2,0,0,2,0,2,6
410377,0,0,0,0,2,0,0,2
1535616,1,2,0,1,8,122,19,153
424993,0,3,1,0,8,1,7,20
1709143,0,0,0,0,1,31,17,49
253798,2,2,1,0,5,0,4,14
1103153,0,1,1,0,2,1,5,10
245844,2,0,0,0,1,0,0,3
120902,0,0,1,0,3,0,4,8
475276,0,1,1,0,6,10,11,29
120094,0,0,0,0,3,0,2,5
271263,0,1,6,0,0,0,4,11
2937696,0,10,2,0,10,206,71,299
1351685,1,0,0,0,0,0,0,1
119173,1,0,3,0,13,33,26,76
4682786,0,1,0,0,0,1,10,12
455824,2,0,0,0,2,1,0,5
1454029,0,0,0,0,12,0,8,20
2172985,1,2,1,1,5,88,22,120
3896198,0,1,2,0,12,0,4,19
1458175,0,2,0,0,2,1,3,8
2870708,0,0,0,0,1,32,8,41
120255,1,1,1,0,2,5,1,11
1213663,4,1,0,3,0,91,19,118
1298650,1,0,0,0,1,0,0,2
1082868,0,0,0,0,8,21,25,54
780521,0,0,0,0,0,0,0,0
433035,0,3,6,0,7,0,2,18
181316,0,6,4,0,21,0,47,78
1385826,1,3,0,0,2,2,15,23
1441395,0,0,0,0,0,2,1,3
146675,0,4,1,0,3,22,9,39
1365050,0,0,0,0,0,53,3,56
1352824,0,0,1,0,2,10,4,17
1186367,0,0,0,0,3,23,9,35
1151359,0,5,0,0,7,47,25,84
395495,0,2,1,0,2,0,5,10
121765,0,0,1,0,1,0,0,2
1979320,3,0,1,1,0,18,10,33
1100089,1,0,0,0,0,0,2,3
443465,1,0,0,0,1,1,15,18
1067774,0,0,1,0,0,0,0,1
283426,0,0,0,0,0,0,0,0
203540,2,0,2,0,1,13,8,26
2388715,0,0,1,0,5,2,7,15
302886,2,2,1,0,10,13,4,32
2402105,2,1,0,9,4,128,14,158
2379713,1,0,1,0,0,0,3,5
758758,1,0,0,0,5,13,6,25
1226753,0,0,0,0,0,14,1,15
118655,2,0,0,0,1,0,3,6
307901,2,5,0,0,2,96,34,139
477071,0,0,0,0,4,1,6,11
1014759,0,0,0,0,0,0,0,0
3322364,1,1,1,0,6,2,5,16
213790,3,2,20,0,2,0,6,33
120484,0,1,0,0,3,1,6,11
376108,0,0,0,0,2,0,0,2
787474,0,0,0,0,0,0,0,0
246544,0,0,0,0,2,0,0,2
277941,9,0,0,0,6,1,3,19
120679,2,4,0,0,6,10,4,26
134618,1,0,0,0,10,29,14,54
2309021,0,1,1,0,3,2,1,8
246578,0,9,2,0,5,30,9,55
3774114,1,1,2,0,6,8,7,25
168629,0,0,0,0,1,0,0,1
120889,0,1,0,0,3,2,3,9
1216492,0,0,1,0,1,0,1,3
1253864,2,0,0,0,0,0,0,2
328538,0,3,1,1,11,47,38,101
1179947,0,0,1,0,9,70,17,97
898367,0,3,0,0,5,5,3,16
455944,0,3,0,0,4,81,15,103
466342,0,3,1,0,4,1,6,15
913354,0,0,0,0,6,1,9,16
120684,0,1,0,0,3,11,2,17
1524137,1,4,1,1,4,167,62,240
1423894,2,4,0,0,12,24,15,57
204946,0,7,4,0,1,0,13,25
183649,0,11,0,0,7,116,17,151
1194417,3,4,2,0,15,65,8,97
375173,0,1,0,0,1,3,4,9
150377,0,4,0,0,2,8,6,20
1674784,0,7,0,0,5,108,23,143
1038919,0,2,4,0,12,0,34,52
850253,0,5,3,0,2,15,2,27
272152,0,3,2,0,7,1,10,23
1560985,0,0,0,0,3,1,0,4
3713166,0,10,0,0,2,132,38,182
120647,1,3,2,0,2,2,6,16
1480656,0,1,0,0,1,5,2,9
119978,1,1,0,0,6,0,0,8
134154,5,1,0,0,14,0,6,26
285531,3,2,1,0,11,26,26,69
2452254,0,2,1,0,6,4,4,17
865559,0,0,4,0,1,0,1,6
262396,0,5,0,0,11,186,63,265
1289401,0,1,1,0,8,1,3,14
1741273,0,8,0,0,7,1,6,22
822389,12,0,10,0,2,20,38,82
389860,2,1,4,0,5,1,12,25
758766,0,1,0,0,0,0,0,1
1194173,0,1,1,0,1,0,10,13
1478338,0,1,3,1,4,29,31,69
327437,0,0,0,0,2,0,0,2
806203,0,3,1,0,5,2,26,37
376136,6,0,1,0,3,30,7,47
289848,0,4,0,0,7,76,13,100
1754656,0,0,0,0,0,0,0,0
1013752,0,1,0,0,4,1,21,27
1837703,2,0,1,0,9,7,15,34
2452042,0,0,0,0,0,0,0,0
312329,0,9,2,0,15,0,30,56
1498569,0,0,0,0,1,0,6,7
1244659,1,1,1,0,3,0,11,17
124179,0,1,0,0,2,74,12,89
165643,0,3,0,0,3,105,60,171
887912,4,4,2,0,4,70,41,125
305669,0,5,1,0,11,0,8,25
3631112,0,1,0,0,0,61,5,67
443473,0,7,0,0,2,48,16,73
1935896,1,4,2,2,2,26,4,41
2345759,1,2,0,0,2,0,1,6
918940,2,0,1,0,2,0,1,6
462244,0,0,2,0,0,0,0,2
1486192,5,1,1,0,8,1,3,19
472043,1,0,0,0,1,1,0,3
315297,2,1,0,1,4,27,9,44
1414382,0,0,0,0,0,0,0,0
1268204,0,0,3,0,0,0,3,6
3460252,12,22,0,0,49,23,18,124
1334553,0,0,0,0,4,8,2,14
369610,0,3,1,0,6,0,9,19
790724,0,2,0,0,5,1,9,17
1838544,0,4,0,0,2,1,6,13
383222,0,1,0,0,0,0,0,1
1172233,0,4,6,0,5,1,10,26
914798,0,0,0,0,1,0,0,1
1690953,0,0,0,0,0,0,0,0
924129,0,11,0,1,10,67,24,113
808399,1,0,0,0,1,11,4,17
346156,0,0,0,0,2,0,0,2
457572,0,0,1,0,3,0,0,4
2004420,0,8,1,1,7,173,76,266
1219827,0,0,0,0,0,0,1,1
120082,0,5,2,0,4,33,26,70
335345,0,0,0,0,1,0,0,1
1336608,1,1,3,0,0,1,9,15
1462758,0,1,0,1,2,26,9,39
301976,5,1,0,0,6,27,21,60
163187,0,0,0,0,0,0,0,0
1057500,1,0,1,0,1,2,3,8
1971352,0,0,0,0,3,10,7,20
482603,0,0,0,0,0,0,0,0
156841,0,5,0,0,3,1,4,13
1924435,0,21,0,0,6,37,81,145
452608,1,10,0,0,12,31,16,70
314412,0,0,0,0,1,9,2,12
2170439,0,10,0,0,19,135,74,238
929632,0,36,0,0,15,72,29,152
417433,0,2,3,0,4,0,4,13
4136084,0,1,0,0,1,0,3,5
356634,0,0,1,0,1,0,0,2
307453,0,0,1,0,0,0,0,1
257516,0,2,0,0,1,13,23,39
1791682,0,0,1,0,4,40,29,74
317132,0,0,0,0,1,0,0,1
185371,0,5,1,0,18,23,18,65
458481,1,6,3,0,22,1,6,39
1920849,0,4,0,2,0,91,33,130
435651,0,0,1,0,0,0,0,1
120915,0,0,0,0,0,0,0,0
861689,0,5,3,2,3,3,3,19
414853,0,0,0,0,0,0,0,0
238112,0,0,0,0,2,3,0,5
1529572,0,2,0,1,1,21,8,33
119164,14,0,2,0,0,28,4,48
1119646,1,3,3,0,12,103,45,167
393597,0,0,0,0,0,0,0,0
1314655,0,0,0,0,4,0,8,12
1213648,1,0,0,29,0,157,12,199
259711,1,4,0,0,0,42,7,54
1068242,0,6,0,0,6,0,20,32
443274,0,2,0,0,5,1,10,18
3488710,1,1,1,0,7,0,7,17
120524,2,1,0,0,4,15,8,30
1411238,0,2,3,0,2,25,9,41
1596343,1,4,1,0,13,1,21,41
398165,4,16,1,0,22,1,58,102
780536,0,0,0,14,1,136,18,169
465502,0,0,0,0,1,0,0,1
118736,0,0,0,0,1,0,0,1
1324999,0,0,3,0,1,0,0,4
461770,0,0,0,0,0,0,0,0
2402927,0,1,1,0,8,2,0,12
796368,0,6,0,0,21,49,43,119
2084989,0,0,0,0,3,0,1,4
1711525,1,10,1,0,8,69,38,127
1186370,0,1,0,1,1,52,11,66
375210,3,0,0,0,2,1,3,9
373926,0,0,1,0,0,0,5,6
399327,0,23,3,0,6,6,34,72
960144,2,4,38,0,2,0,11,57
246989,0,2,4,0,8,13,9,36
249462,2,0,2,0,0,44,9,57
1212436,0,3,0,0,4,1,19,27
770772,0,8,1,0,6,68,21,104
2872732,0,0,0,0,1,1,4,6
873886,0,11,2,0,14,127,15,169
120478,0,0,3,0,2,0,0,5
790686,0,1,1,0,7,11,5,25
121766,0,0,0,0,0,0,0,0
164212,0,2,3,0,9,9,5,28
257106,0,13,0,0,4,34,34,85
450340,1,7,0,0,5,53,40,106
416315,2,4,2,4,0,33,17,62
410764,0,2,1,0,4,4,2,13
821642,0,3,3,0,3,2,8,19
387131,0,3,0,0,0,15,3,21
385726,0,0,2,0,1,0,0,3
1013753,0,0,1,0,6,15,9,31
1031280,3,2,0,0,25,5,8,43
3393786,0,2,1,0,4,0,11,18
1712170,1,5,0,0,6,0,1,13
368447,0,0,0,0,0,0,0,0
171804,1,1,0,0,11,101,15,129
463985,0,1,0,0,8,1,11,21
1702439,0,0,2,0,2,0,5,9
1666801,0,4,0,0,2,1,16,23
163025,0,0,0,0,3,0,0,3
119951,2,3,2,1,12,38,8,66
4853102,0,2,2,0,3,0,1,8
455760,0,0,0,0,1,0,1,2
156934,1,4,0,0,4,1,3,13
266697,2,9,0,2,7,16,9,45
433383,0,0,0,0,3,0,0,3
120646,0,1,0,0,1,2,6,10
999913,0,5,0,0,28,101,29,163
166175,35,5,0,0,0,22,8,70
1267297,3,0,1,0,1,1,3,9
265349,0,3,0,0,3,1,5,12
374536,0,0,2,0,1,0,0,3
364725,1,4,2,0,6,2,1,16
381971,0,0,0,0,0,0,0,0
250494,1,3,0,0,1,0,1,6
902272,0,3,0,0,1,0,0,4
3450958,0,0,0,0,1,0,0,1
1723811,0,1,0,0,0,65,8,74
1216491,0,5,0,0,6,27,19,57
1602613,0,1,0,2,0,10,0,13
1980209,0,13,3,1,7,153,67,244
181739,0,0,0,0,1,0,0,1
120685,2,0,1,0,8,0,1,12
427309,0,0,0,0,1,0,4,5
1010048,2,0,1,0,1,2,7,13
370032,1,1,0,0,3,0,2,7
1253863,0,0,0,0,1,3,1,5
2784678,0,10,0,0,8,77,37,132
1981107,0,0,2,0,0,0,3,5
120681,2,2,0,1,1,13,0,19
3949660,0,0,0,0,2,0,0,2
997047,0,0,0,0,0,0,0,0
455957,3,0,0,0,2,0,0,5
444682,0,0,0,0,7,1,4,12
1568338,0,7,1,0,9,2,14,33
1104001,0,0,0,0,1,0,0,1
433387,0,15,1,0,24,314,163,517
424823,1,2,2,0,1,0,6,12
2294677,0,1,1,1,7,6,12,28
1488555,3,6,2,0,11,117,36,175
298203,1,24,1,0,9,162,91,288
1028528,6,31,1,0,21,136,42,237
313542,3,3,1,0,5,1,12,25
1592525,0,7,1,0,4,1,12,25
970179,0,0,0,0,0,0,0,0
1496025,0,0,0,0,0,4,5,9
1809398,0,1,0,0,7,1,4,13
293815,3,25,0,0,54,58,79,219
1193631,0,0,0,0,0,0,0,0
1013743,0,1,2,0,1,0,4,8
119558,1,0,0,0,3,2,0,6
2752772,1,1,0,1,3,8,1,15
462335,7,0,0,1,3,12,2,25
120483,4,1,2,0,5,0,1,13
2304933,0,0,0,0,0,1,8,9
3410834,0,0,0,0,2,0,4,6
443489,0,1,1,0,1,1,23,27
338512,0,0,0,0,0,0,0,0
361467,0,0,1,0,0,0,0,1
445946,1,1,0,0,2,1,8,13
2431286,0,0,1,0,0,2,2,5
1683876,0,3,0,0,0,0,0,3
417741,0,0,0,0,0,0,0,0
1976000,0,1,1,0,0,2,6,10
1586752,1,4,0,0,4,47,22,78
1034303,0,2,0,0,0,5,9,16
2294449,0,17,2,0,7,220,96,342
212338,0,3,0,0,5,1,8,17
322589,0,4,0,0,5,0,8,17
3014866,2,3,0,0,12,6,3,26
2714900,0,0,0,0,0,0,0,0
163579,2,0,1,0,18,13,58,92
926129,1,3,1,0,8,0,2,15
1578275,1,10,0,0,12,1,14,38
2193215,2,3,0,0,2,30,13,50
165929,0,3,0,0,19,3,26,51
1017451,0,6,3,1,0,65,28,103
2649554,0,0,0,0,0,0,1,1
146882,4,2,2,0,1,57,15,81
277371,0,4,1,0,24,10,19,58
1645170,1,0,0,0,0,10,2,13
328107,0,0,0,0,3,15,1,19
337741,0,1,0,0,2,2,1,6
398808,0,0,0,0,4,0,0,4
338466,2,3,3,0,1,1,8,18
1020558,4,1,0,0,5,11,8,29
118929,0,0,0,0,4,0,0,4
1091191,1,1,1,0,4,193,17,217
389722,0,1,0,0,1,12,7,21
1082853,0,1,0,0,2,9,6,18
121164,0,0,10,0,1,0,0,11
2614684,6,2,0,4,0,101,7,120
483726,1,1,0,0,0,1,11,14
243017,1,0,0,0,1,5,3,10
825232,0,1,0,0,12,1,10,24
1311067,0,16,1,1,8,135,21,182
409345,0,1,0,0,7,108,26,142
318761,0,1,0,0,1,11,8,21
489237,1,1,0,0,2,1,6,11
1355631,0,5,0,0,6,101,28,140
368709,0,0,0,0,0,2,4,6
303816,0,2,1,0,7,115,36,161
146316,1,0,0,0,0,0,2,3
119174,1,2,0,0,10,31,10,54
4680182,0,1,0,0,1,20,25,47
122690,1,0,0,0,2,14,2,19
829150,0,0,0,0,0,0,0,0
842929,0,0,0,0,2,1,4,7
430922,0,4,2,0,8,36,32,82
349710,0,2,1,0,5,1,6,15
2510894,0,0,0,0,0,0,0,0
380510,0,1,1,0,0,1,0,3
397078,0,1,4,0,4,0,4,13
359517,0,0,1,0,4,0,0,5
4044364,0,0,0,0,1,8,0,9
3322940,0,0,0,0,0,0,0,0
452625,0,2,1,0,1,18,13,35
499554,0,5,0,0,14,44,30,93
258153,0,2,0,0,1,0,2,5
356618,0,1,0,0,4,1,1,7
482606,0,1,0,0,0,12,4,17
181852,1,3,0,0,7,3,8,22
2400463,1,0,0,0,0,28,5,34
1022603,0,2,4,0,5,1,12,24
357507,0,0,1,0,1,0,0,2
2637276,3,9,0,0,10,131,74,227
452624,0,1,1,1,2,23,4,32
208003,0,0,0,0,18,0,19,37
120737,0,0,1,0,0,0,0,1
361089,0,0,0,0,0,0,0,0
443701,0,0,1,0,1,0,2,4
798817,0,2,0,0,2,34,5,43
1587707,0,0,0,0,1,6,2,9
157583,1,1,1,0,2,4,2,11
1821549,1,5,0,0,12,2,10,30
1449283,0,0,0,0,0,0,0,0
1683526,1,10,2,0,1,57,21,92
1598828,1,2,13,0,15,1,15,47
1924394,11,0,6,8,3,182,14,224
144528,1,5,0,0,24,2,12,44
118531,2,13,0,0,4,42,33,94
1596346,0,0,0,0,0,0,0,0
118900,0,11,1,0,34,190,44,280
1355630,0,2,1,0,1,0,11,15
190590,0,13,0,0,39,0,0,52
1506999,0,0,0,0,0,2,7,9
1731141,0,0,1,0,1,0,0,2
397535,1,0,1,0,0,0,0,2
263488,0,5,1,0,9,14,12,41
1440728,1,0,0,0,0,0,0,1
455407,1,2,1,0,8,44,31,87
1282140,0,11,0,0,10,0,19,40
1403177,5,0,2,0,29,22,6,64
2383068,0,0,0,0,0,13,14,27
396171,0,0,1,0,1,0,0,2
1470827,0,0,0,0,0,7,1,8
3567288,0,2,4,0,3,1,2,12
280707,2,1,0,0,3,6,2,14
298148,0,0,0,0,0,0,0,0
936501,0,0,0,0,2,0,4,6
118928,0,3,1,0,4,0,7,15
1439572,0,0,0,2,3,25,3,33
297284,0,2,0,0,7,23,8,40
252866,1,6,0,0,1,37,30,75
1764183,0,1,0,0,5,73,6,85
1650554,1,24,0,1,10,41,31,108
365748,0,0,1,1,0,43,3,48
425123,0,0,1,0,1,0,2,4
399295,0,0,0,0,3,53,10,66
1320244,0,1,0,0,1,0,1,3
440963,0,0,0,0,5,0,3,8
479884,0,13,0,1,2,95,49,160
482571,0,0,0,0,2,0,0,2
445990,0,0,0,0,2,0,0,2
4465564,0,1,0,0,3,12,8,24
1174732,2,0,1,0,0,0,0,3
450345,0,2,0,0,3,1,2,8
1403981,1,1,1,0,4,2,19,28
1018818,0,8,0,0,4,17,14,43
405422,0,18,0,0,7,103,41,169
2024469,1,2,0,0,15,2,13,33
4190530,0,0,0,0,0,0,0,0
349467,1,8,0,0,3,39,15,66
976051,0,0,0,0,0,0,0,0
1322269,0,6,0,1,28,29,22,86
1014763,0,2,0,0,2,14,7,25
119217,0,11,3,0,4,142,29,189
211181,0,0,1,0,0,0,0,1
907657,0,0,0,0,1,40,3,44
454876,0,0,0,0,0,0,0,0
1121096,0,0,0,0,2,1,0,3
250687,2,4,2,0,3,1,10,22
2980210,0,0,1,0,3,2,6,12
1666186,0,4,1,0,6,0,13,24
120657,1,0,0,0,2,0,0,3
147800,0,8,1,0,8,0,6,23
1517260,0,0,0,0,1,0,0,1
433386,0,0,0,0,1,0,0,1
171356,0,1,3,0,0,4,3,11
1691917,0,0,0,0,0,0,0,0
183659,0,6,0,2,12,14,6,40
268126,0,2,1,0,7,36,13,59
1518812,0,1,6,0,0,0,0,7
1068680,1,0,1,0,4,2,9,17
2103217,0,0,1,0,1,15,5,22
1438254,0,1,3,0,1,0,3,8
3544082,1,0,0,0,0,8,2,11
1416801,1,1,1,0,3,52,10,68
330373,0,0,0,0,1,0,0,1
805526,0,0,0,0,0,0,0,0
120696,4,8,1,0,13,2,22,50
186045,0,0,1,0,7,1,15,24
2403021,0,3,1,0,0,55,7,66
298228,1,0,0,0,1,0,1,3
361841,3,0,1,0,3,0,3,10
408306,0,1,1,0,2,18,12,34
1764234,9,4,0,0,1,211,34,259
372183,0,1,2,0,3,1,3,10
122718,1,0,5,0,7,0,0,13
202470,3,0,3,0,2,12,13,33
120669,26,5,0,0,49,105,60,245
1481572,0,0,2,0,2,25,7,36
481536,0,9,2,0,3,155,63,232
1131734,0,1,1,0,3,19,13,37
3824458,0,63,0,0,7,249,65,384
458525,0,1,0,0,7,0,3,11
1181791,1,4,0,0,1,5,0,11
268695,1,0,0,0,2,0,0,3
139462,0,2,0,0,4,0,1,7
120133,0,0,0,0,2,0,0,2
120655,2,8,2,0,4,96,44,156
132245,0,3,1,0,7,0,1,12
1661199,0,0,1,0,0,0,0,1
1456941,0,0,0,0,0,1,9,10
2109248,1,8,5,0,4,1,10,29
119229,1,1,1,0,6,20,5,34
379217,2,0,0,0,7,34,9,52
378109,0,0,0,0,0,0,0,0
387877,0,3,1,1,4,21,5,35
952640,0,0,0,0,0,1,0,1
295297,0,0,0,0,1,0,0,1
2203939,0,2,0,0,3,2,33,40
454848,0,3,2,1,7,72,35,120
758774,0,0,1,0,6,51,20,78
1014775,0,0,0,0,0,0,0,0
469263,0,2,0,0,2,0,2,6
815245,0,2,0,0,2,1,3,8
1790809,0,0,1,0,0,0,0,1
280665,0,12,1,0,7,33,8,61
457400,6,4,4,0,9,2,6,31
295254,0,0,0,0,3,13,9,25
2402101,0,7,5,1,4,37,13,67
466839,0,5,0,0,0,0,9,14
355702,1,7,2,0,2,16,33,61
1034314,1,3,1,0,3,20,11,39
1212419,0,0,0,0,3,0,1,4
374900,0,0,7,0,0,0,0,7
1174730,0,8,3,0,2,1,19,33
1129423,0,0,0,0,0,0,0,0
230011,0,0,0,0,0,0,0,0
2582846,1,2,0,0,2,1,7,13
183505,2,9,5,0,21,52,27,116
338459,0,0,0,0,0,0,0,0
119349,0,0,1,0,3,4,7,15
256380,0,0,2,0,1,1,12,16
1535438,0,1,1,0,4,0,0,6
454082,0,8,2,0,3,37,18,68
2820852,3,4,0,0,11,0,18,36
431197,1,3,0,0,5,28,9,46
239948,0,8,0,0,26,8,14,56
1843866,0,2,0,0,6,0,2,10
261289,0,8,2,0,22,0,3,35
1483013,0,3,0,0,4,1,5,13
1024715,0,0,1,0,2,31,17,51
162710,0,0,0,0,2,5,17,24
449010,0,0,0,0,0,0,0,0
1596350,1,3,1,0,2,1,6,14
1496422,0,8,1,0,9,62,24,104
362227,0,0,0,0,1,0,4,5
1924396,0,0,0,0,0,1,1,2
1386697,1,8,1,0,10,0,32,52
272020,1,6,0,0,8,38,11,64
120906,0,0,0,0,0,20,8,28
120912,0,2,4,0,8,0,0,14
1045670,2,3,3,0,0,15,4,27
1392190,0,0,0,0,0,0,0,0
1045658,0,0,0,0,4,72,24,100
3183660,0,0,0,0,0,0,0,0
2562232,1,3,3,0,6,99,38,150
1212974,2,7,3,0,4,22,16,54
4786282,0,1,0,0,0,0,6,7
119177,0,0,0,0,2,1,0,3
1073498,0,6,3,0,6,0,13,28
133952,0,0,0,0,4,16,16,36
119822,1,3,2,0,2,3,6,17
167456,0,0,0,0,2,0,0,2
204175,1,0,0,0,0,0,3,4
448124,1,0,2,0,0,7,3,13
325805,0,4,0,0,3,2,17,26
4520364,0,0,0,0,4,10,5,19
251160,2,5,1,0,10,1,8,27
810922,7,5,1,0,6,48,39,106
283026,0,0,1,0,0,0,8,9
910936,2,9,0,0,7,157,79,254
181689,1,0,0,0,3,1,6,11
1176251,0,0,1,0,9,26,14,50
490215,0,0,0,0,1,0,1,2
120735,13,0,2,2,0,130,21,168
357277,0,2,0,0,6,0,4,12
120053,4,1,0,0,6,1,0,12
377818,3,12,3,0,27,7,17,69
942903,0,0,1,0,2,0,1,4
499556,2,1,1,0,3,28,9,44
2097298,0,0,1,0,1,0,0,2
1735898,0,0,2,0,1,0,0,3
1637725,4,4,2,1,2,58,49,120
1240982,4,3,1,0,3,44,24,79
775552,0,0,1,0,0,0,0,1
478970,0,1,0,0,10,0,4,15
489037,0,0,0,0,0,0,1,1
266915,0,4,3,0,11,0,5,23
278295,4,26,1,0,32,175,92,330
398375,1,1,0,0,2,0,3,7
1605783,0,0,0,0,2,0,1,3
372784,0,0,1,0,6,0,1,8
242653,3,1,0,0,19,0,14,37
1160368,1,5,1,0,8,2,14,31
216216,5,10,2,0,9,1,18,45
2626350,1,0,4,0,2,1,3,11
160338,2,0,1,0,2,22,6,33
125664,1,0,3,0,3,7,8,22
3622592,0,1,0,0,4,0,6,11
120913,0,0,0,0,0,0,0,0
2002718,3,11,1,0,13,56,18,102
120907,1,0,0,0,1,5,1,8
1758692,0,0,0,0,0,1,3,4
450232,0,0,1,0,7,2,20,30
1667310,0,2,0,0,5,21,11,39
486674,3,1,0,0,4,54,6,68
2848292,0,4,1,0,3,0,2,10
1596345,0,0,1,0,2,1,4,8
1250777,0,2,3,1,3,98,35,142
443272,0,3,1,0,18,2,4,28
242445,4,3,1,0,6,22,56,92
2084970,2,0,0,0,6,0,0,8
945513,1,0,0,0,5,1,4,11
464154,0,2,1,0,0,14,7,24
465538,1,1,1,1,11,18,11,44
1343092,0,1,1,0,5,0,0,7
1195478,0,3,0,1,3,48,21,76
154506,1,0,0,1,0,31,11,44
1082886,0,6,1,0,3,49,21,80
462519,0,4,1,0,17,5,13,40
373883,0,16,0,1,9,93,27,146
339034,0,0,1,0,0,0,0,1
331468,2,2,0,0,2,20,10,36
1320253,1,0,0,0,3,0,0,4
372237,0,0,0,0,11,0,12,23
1531663,0,0,3,0,1,6,7,17
1285016,0,5,0,0,3,3,10,21
4052882,0,0,0,0,0,1,2,3
398017,2,6,2,0,3,59,21,93
482572,0,1,3,0,20,19,18,61
985694,1,3,3,0,7,26,9,49
315327,1,0,2,0,2,1,5,11
365830,0,3,1,0,12,113,22,151
2333804,3,2,0,0,0,18,5,28
1499658,5,9,1,0,11,101,52,179
416449,0,0,0,0,0,0,0,0
1024648,1,1,0,0,4,25,9,40
292506,0,1,0,0,5,1,11,18
382932,0,0,0,0,0,0,0,0
450385,1,0,1,0,2,0,6,10
815244,0,2,1,0,3,0,0,6
360009,0,8,1,0,0,29,3,41
120481,0,0,0,0,1,0,0,1
1374992,0,0,0,0,3,0,1,4
1536044,0,0,2,0,2,32,7,43
402399,2,0,0,0,1,0,0,3
431021,0,0,0,0,1,0,1,2
1270262,0,1,1,5,0,68,2,77
1293847,1,6,1,0,11,1,28,48
2293640,0,0,0,0,0,0,0,0
195945,0,25,0,0,49,110,116,300
403508,0,0,0,0,0,0,0,0
345074,1,0,1,0,0,0,0,2
1598778,0,0,0,0,0,1,6,7
429493,2,0,2,0,16,5,5,30
1272878,0,9,2,0,11,28,34,84
171433,1,0,0,0,3,0,2,6
2390361,0,3,6,0,1,1,10,21
239395,0,0,1,0,0,0,0,1
1289406,3,3,1,11,1,122,23,164
309530,1,1,0,0,0,0,0,2
401445,6,0,0,0,1,3,18,28
822832,1,2,6,0,1,0,1,11
1086772,0,1,3,0,3,0,2,9
423169,0,8,0,2,7,36,13,66
903624,0,0,0,0,0,0,0,0
2788732,0,0,1,0,0,0,0,1
1981677,0,9,2,0,1,0,6,18
2473510,0,0,0,0,0,54,16,70
427327,0,0,0,0,4,0,0,4
1127180,0,4,0,0,2,1,3,10
364045,1,0,0,0,0,19,8,28
120873,1,5,0,0,5,1,15,27
1093357,2,0,3,0,13,25,6,49
2106361,0,1,0,0,8,0,37,46
485947,0,0,0,0,1,2,1,4
159365,3,0,0,0,6,0,8,17
2503944,2,0,0,0,0,63,7,72
800308,2,4,0,0,6,3,5,20
355295,1,0,0,0,1,0,1,3
800320,2,1,1,0,0,0,0,4
1148204,0,2,2,0,1,11,1,17
137494,3,2,0,0,5,2,7,19
122933,3,2,0,0,0,60,20,85
1058017,1,2,1,0,0,1,1,6
427470,0,1,0,0,6,35,17,59
1853728,1,17,0,0,37,31,16,102
264935,0,1,1,0,3,8,4,17
175880,0,2,0,2,17,164,35,220
295700,0,0,0,0,3,12,10,25
258000,0,5,0,0,9,59,21,94
167260,0,0,0,0,0,0,0,0
1674771,0,4,1,2,8,122,22,159
2381249,0,0,1,0,1,0,3,5
386032,0,1,1,0,0,0,0,2
1313092,0,1,0,3,0,82,15,101
1618442,0,2,1,0,1,0,2,6
265632,0,0,0,0,0,0,0,0
2039393,0,1,0,0,3,114,19,137
1791528,1,2,0,0,1,53,16,73
160916,0,0,0,0,9,19,6,34
477051,3,25,1,0,31,0,11,71
3062096,0,1,0,0,4,1,3,9
2234155,0,9,3,0,6,13,31,62
3139086,0,3,6,0,5,0,2,16
223897,1,8,3,0,6,0,23,41
118661,0,0,0,0,0,0,0,0
124198,3,5,2,0,26,122,13,171
3177316,0,0,0,0,0,14,3,17
308353,0,0,0,0,0,0,0,0
2870648,1,0,1,2,0,12,4,20
1582507,0,4,0,0,1,0,1,6
938330,0,0,0,0,3,3,2,8
450405,0,1,3,0,5,0,5,14
1531901,2,6,3,2,2,14,3,32
1032755,14,0,0,0,1,94,8,117
1837709,0,2,0,0,3,0,1,6
1418377,0,0,1,0,1,0,1,3
2278388,1,3,0,0,10,12,6,32
290334,0,0,0,0,0,0,2,2
319262,1,0,0,0,5,0,4,10
985699,1,0,0,0,3,1,0,5
2177771,0,1,0,0,8,0,9,18
119345,0,0,2,0,4,33,19,58
1951261,0,0,0,0,4,92,28,124
1046163,0,5,0,3,4,52,36,100
160862,0,5,1,0,7,2,8,23
264464,0,0,0,0,12,1,3,16
986233,6,0,1,0,2,13,4,26
282687,0,0,1,0,0,1,5,7
4172430,0,3,1,0,10,75,33,122
790712,1,2,1,0,6,42,18,70
118715,1,3,0,0,10,255,34,303
417148,1,5,3,0,10,37,20,76
1584016,0,0,0,0,0,0,3,3
213149,0,8,2,0,14,0,13,37
439289,3,4,1,3,9,24,17,61
256415,1,4,0,0,6,0,7,18
3169706,3,0,1,0,0,10,5,19
3442006,0,5,0,1,2,26,15,49
2660888,0,0,1,0,7,0,2,10
236493,4,1,0,0,3,62,26,96
267804,0,4,0,0,1,0,12,17
164184,0,0,0,0,9,1,10,20
219699,1,7,0,0,18,13,3,42
199753,0,2,1,0,5,1,13,22
481499,0,0,0,0,0,0,0,0
227005,1,2,0,0,11,216,66,296
2908446,0,0,0,0,2,0,2,4
371257,0,0,2,0,4,17,4,27
471030,2,1,0,4,0,48,7,62
143261,0,0,2,0,6,20,17,45
2322441,0,0,0,0,0,7,1,8
800240,1,0,1,0,0,10,8,20
1318514,0,0,0,0,5,0,1,6
181875,0,1,0,0,4,35,4,44
1528854,1,8,1,0,9,0,17,36
179116,0,1,1,0,1,7,4,14
842926,0,3,1,0,0,36,19,59
1024255,0,3,2,0,1,0,9,15
1638355,0,0,0,0,1,0,0,1
2545118,0,0,0,0,2,0,1,3
411061,0,3,1,0,10,0,5,19
2866360,1,0,1,0,1,40,13,56
209475,2,0,1,0,4,1,3,11
2359024,0,2,0,0,2,21,9,34
137523,0,4,4,0,8,78,17,111
1541160,3,3,0,1,8,128,21,164
1172991,4,2,0,0,7,19,13,45
1679335,0,0,4,0,0,0,0,4
133751,1,7,0,0,8,60,21,97
408524,2,7,8,0,20,0,38,75
1850397,1,5,3,0,6,60,18,93
2674426,0,1,0,0,2,0,1,4
2347569,1,3,1,1,4,30,14,54
3544112,1,3,0,0,0,1,24,29
120738,0,0,1,0,9,0,3,13
810913,0,0,1,0,1,0,0,2
1798684,0,10,0,0,4,89,40,143
3691740,0,0,1,0,0,0,0,1
1528100,0,0,0,0,0,0,0,0
800241,0,2,1,0,0,9,11,23
384793,0,2,6,0,6,1,57,72
373469,2,10,0,1,9,66,33,121
4975722,0,7,0,0,20,25,37,89
2318092,0,0,0,0,2,1,9,12
219854,0,0,0,0,1,0,0,1
281358,0,0,0,0,3,0,12,15
116922,0,2,0,0,3,28,7,40
412019,0,0,1,0,2,9,1,13
123755,0,1,0,0,0,26,3,30
385880,0,0,1,0,0,0,0,1
240510,0,0,1,0,0,0,0,1
257044,0,0,0,0,2,7,2,11
1594562,1,1,0,0,1,6,7,16
2404435,1,8,0,0,20,1,8,38
1077368,2,1,0,0,6,1,2,12
118927,3,2,0,0,11,58,24,98
1895587,1,1,3,0,6,6,25,42
3072482,0,0,0,1,0,39,16,56
375568,0,0,3,0,0,0,0,3
1322312,0,3,0,0,5,64,21,93
318974,0,3,2,0,5,0,3,13
1985019,0,0,2,0,0,0,0,2
814022,0,0,0,0,2,5,2,9
272207,0,8,3,0,6,266,78,361
239986,0,1,6,0,3,45,10,65
1196141,0,0,2,0,0,0,0,2
1911644,0,3,0,0,2,3,8,16
176783,0,6,0,0,0,2,8,16
1713476,0,2,0,0,4,10,13,29
454919,0,1,0,0,7,1,6,15
1855199,0,19,0,0,9,374,116,518
2980592,0,2,0,0,4,19,9,34
1582248,0,1,1,0,8,39,18,67
974661,2,1,0,0,1,0,0,4
413267,0,0,0,0,0,0,0,0
1392214,0,0,0,0,3,54,15,72
1292566,0,2,1,0,0,16,18,37
182789,0,1,0,0,4,0,7,12
417001,2,0,0,0,3,0,1,6
426592,0,6,1,0,6,2,20,35
367959,1,1,0,0,1,7,0,10
318155,0,0,1,0,0,0,0,1
326905,4,6,0,0,10,0,1,21
141926,1,4,1,0,17,0,13,36
318627,0,3,0,0,2,13,14,32
1915581,0,0,2,0,5,164,37,208
457419,0,0,1,0,0,0,0,1
1135985,0,9,0,1,21,108,68,207
1034331,0,6,1,0,5,104,42,158
1116184,0,2,1,0,4,121,47,175
398027,1,3,1,0,5,25,7,42
141098,0,2,0,0,3,1,4,10
1231583,0,3,1,0,4,39,11,58
1029360,0,1,1,0,2,0,5,9
2404233,0,0,0,0,1,0,0,1
1228987,1,1,2,0,0,9,3,16
1155056,0,4,4,0,4,66,20,98
118884,1,1,0,0,0,0,2,4
1428538,0,7,0,0,3,15,9,34
373051,0,0,0,0,0,0,0,0
417217,0,3,0,0,2,70,30,105
1028532,0,0,0,0,0,0,0,0
311429,1,0,0,0,3,0,0,4
1453405,0,0,0,0,0,0,0,0
215129,0,3,3,0,3,7,4,20
319061,0,1,0,0,4,0,2,7
167261,0,0,0,0,0,0,0,0
120102,1,0,0,0,0,0,5,6
1489889,0,4,0,0,8,22,53,87
295701,0,3,0,0,3,0,17,23
1279935,0,7,0,0,3,3,4,17
485985,1,3,3,0,22,0,7,36
2101341,0,1,0,0,0,63,27,91
433362,1,2,0,0,4,12,16,35
955308,6,0,0,0,0,0,0,6
199626,0,2,1,0,3,57,13,76
2119532,3,1,1,0,0,2,2,9
151738,0,0,0,0,4,0,3,7
317919,0,3,0,0,5,0,4,12
1375666,1,0,0,0,8,0,0,9
3045616,3,2,0,0,5,2,0,12
1661382,1,8,6,0,15,0,40,70
340855,2,1,0,0,0,150,32,185
455967,1,0,3,0,5,0,6,15
1054606,3,3,1,0,1,0,3,11
421994,1,0,2,0,4,3,4,14
361127,0,3,0,0,4,26,17,50
1375670,0,0,1,0,2,0,1,4
120841,1,4,2,0,16,14,3,40
349683,4,0,0,0,2,0,0,6
2023690,0,2,0,0,0,19,5,26
1637688,0,0,0,0,5,1,3,9
2140479,0,3,1,0,4,29,11,48
435705,0,0,0,0,1,0,3,4
433412,0,0,1,0,1,0,1,3
163978,5,0,0,0,10,63,15,93
120855,0,0,0,0,0,0,0,0
1974419,0,0,0,0,0,8,3,11
1487118,3,0,1,0,0,0,8,12
1179031,2,6,0,0,10,19,21,58
245046,1,0,0,0,0,1,4,6
352248,6,11,6,0,15,0,8,46
2771372,1,13,2,0,3,1,9,29
1448755,13,2,2,0,1,57,25,100
3203606,3,2,3,0,4,23,20,55
2209764,0,0,0,0,0,0,2,2
3717490,0,1,1,0,2,1,4,9
1372686,2,0,0,0,0,0,0,2
300532,0,2,3,0,3,0,24,32
1470023,1,2,1,43,12,57,22,138
221073,2,0,0,6,0,150,14,172
1570989,0,3,1,2,0,30,11,47
1121931,3,11,0,5,6,170,29,224
3316948,0,7,0,0,2,91,35,135
3316960,0,0,0,0,3,1,1,5
3682448,0,4,0,0,4,2,1,11
3152624,0,3,0,0,2,68,27,100
314786,1,2,0,0,1,1,3,8
155776,0,10,0,0,2,17,9,38
2088003,0,3,0,0,7,0,6,16
195234,2,0,1,0,0,14,5,22
266489,0,1,1,0,1,0,2,5
1931435,0,0,2,1,0,13,12,28
1862079,0,2,0,0,4,13,18,37
122529,0,0,1,0,1,12,8,22
770752,3,3,1,0,11,1,28,47
457433,2,6,0,0,1,43,22,74
126029,0,0,1,0,8,0,0,9
252076,0,1,0,0,5,0,4,10
120458,2,2,2,0,17,8,21,52
970411,0,0,2,0,0,0,0,2
1178663,0,1,0,0,6,0,0,7
396752,0,0,0,0,0,0,0,0
2446980,0,1,0,0,0,0,0,1
1571249,1,0,0,0,2,23,38,64
472062,1,0,0,0,5,37,10,53
371724,0,0,0,0,0,0,0,0
142342,0,0,4,0,9,0,11,24
425112,2,0,0,1,1,18,9,31
1320261,0,1,0,0,0,0,0,1
780516,0,0,1,0,1,1,1,4
852713,1,9,3,0,1,1,0,15
838247,0,0,0,0,2,21,11,34
287717,0,0,0,0,0,0,0,0
372588,3,2,0,0,8,77,13,103
1456635,3,5,2,0,3,192,44,249
1596363,0,2,4,0,3,82,46,137
401729,0,0,0,0,3,0,0,3
1912398,1,5,0,1,6,38,11,62
1018785,1,0,0,0,0,0,1,2
1869716,0,1,0,0,0,0,7,8
330793,0,4,0,0,3,9,8,24
387059,0,0,0,0,1,2,1,4
1156398,5,4,1,0,2,29,14,55
2387559,0,1,0,0,1,1,2,5
358349,0,0,0,0,0,0,0,0
1595656,0,0,0,0,0,0,0,0
4196776,0,1,0,0,2,0,3,6
1985966,0,0,2,0,0,0,0,2
1772288,0,1,1,0,3,37,24,66
299930,0,3,0,0,1,111,14,129
1305591,0,0,0,0,0,0,0,0
1640548,0,5,0,0,6,56,18,85
3068194,0,0,0,0,0,0,0,0
2911666,0,0,0,0,2,34,9,45
2223990,2,2,1,0,15,1,16,37
186894,0,1,1,0,3,1,8,14
1839492,0,0,0,0,2,20,11,33
899106,0,3,1,0,10,0,4,18
3263904,0,1,0,0,3,1,7,12
134983,0,0,0,0,0,0,1,1
317648,1,0,0,0,2,0,0,3
430912,0,3,0,1,0,19,0,23
411705,0,0,0,0,0,23,0,23
3385516,0,0,0,0,1,1,0,2
3960412,0,8,1,0,4,75,67,155
1924429,0,0,0,0,0,21,1,22
3397884,0,2,0,0,3,55,13,73
1190080,6,0,0,0,8,1,3,18
458339,0,1,2,0,2,0,0,5
350258,4,4,4,0,36,0,1,49
1323594,0,0,0,0,0,0,0,0
435670,0,3,1,0,7,2,3,16
188674,1,6,0,4,0,249,36,296
1996264,0,4,0,0,4,34,13,55
959337,1,0,1,0,18,10,3,33
2224026,0,0,0,0,0,0,0,0
1345836,1,3,0,0,3,0,0,7
265208,0,6,0,0,6,50,14,76
469641,2,2,1,0,6,1,5,17
956038,0,1,1,0,1,0,1,4
388182,0,0,2,0,3,3,5,13
237572,4,0,0,0,5,9,0,18
1482459,0,0,0,0,0,0,0,0
2473682,0,3,0,0,5,181,157,346
1041829,0,6,4,0,3,0,2,15
1242432,1,19,0,1,15,51,49,136
418279,0,2,5,0,3,0,7,17
469494,5,0,0,0,3,0,1,9
796375,1,1,1,0,2,24,11,40
183523,1,2,0,0,4,0,0,7
770828,0,0,1,0,3,0,1,5
4276820,0,3,1,0,7,1,2,14
191133,1,0,0,0,0,0,1,2
264472,0,1,0,0,2,11,9,23
338325,0,6,1,0,8,0,10,25
1655420,1,0,1,0,2,7,2,13
189998,1,0,0,0,1,2,2,6
129290,0,1,2,0,5,0,6,14
419749,2,0,1,0,5,77,16,101
493464,0,1,0,0,2,47,28,78
1023114,1,0,0,0,4,2,1,8
465494,1,1,1,0,1,0,0,4
302640,0,2,1,0,4,1,5,13
443453,1,2,0,0,3,21,11,38
1228953,0,1,1,0,0,84,20,106
3783958,0,0,1,0,3,1,4,9
5168192,4,0,1,1,0,26,7,39
1217209,0,0,0,0,0,0,0,0
2910814,0,0,1,0,3,1,14,19
1231580,0,0,0,0,0,0,0,0
416320,0,0,0,0,1,1,0,2
118688,0,0,0,0,3,0,0,3
139134,0,3,1,0,0,15,11,30
462338,1,2,0,0,9,29,9,50
218817,2,0,0,0,1,1,5,9
379557,1,0,0,0,1,3,0,5
1374989,1,0,0,0,0,0,0,1
2567026,0,0,0,0,0,0,0,0
1402488,0,0,0,0,1,0,0,1
772193,1,1,0,0,5,17,23,47
463998,0,3,0,0,12,2,12,29
379225,0,0,0,0,0,0,1,1
1046997,7,3,1,0,25,24,19,79
1726592,1,0,0,0,0,4,4,9
419946,1,6,0,0,3,1,3,14
1053424,2,1,1,0,6,4,7,21
422720,0,0,0,0,0,0,0,0
335013,0,0,1,0,0,1,1,3
1071875,0,0,0,0,1,0,2,3
367027,0,4,0,1,0,40,6,51
118887,1,12,0,0,6,89,44,152
1563738,3,0,0,0,1,1,0,5
424345,0,0,2,0,4,141,37,184
758746,0,2,1,0,6,83,56,148
140352,0,0,1,0,4,34,11,50
4438848,0,3,1,0,7,109,38,158
250310,2,5,3,0,7,0,16,33
259446,0,0,0,0,0,0,1,1
278488,3,57,0,0,33,111,89,293
367594,0,0,0,0,0,0,0,0
397101,0,1,0,0,5,1,4,11
120667,0,0,2,0,4,0,0,6
368658,0,1,0,0,2,5,0,8
325980,1,0,0,0,3,0,0,4
1067583,2,0,0,0,2,0,0,4
3521164,0,0,1,0,0,0,0,1
2170593,0,3,3,0,5,1,19,31
413099,0,0,0,0,0,0,0,0
1226229,2,6,0,1,3,131,36,179
1161864,0,1,2,0,1,1,4,9
335563,0,3,0,0,13,140,42,198
351977,1,3,1,0,0,1,3,9
120844,1,0,0,0,1,0,0,2
184894,0,4,1,0,8,0,7,20
316396,0,0,0,0,1,0,0,1
280486,0,7,1,0,6,1,17,32
259324,0,3,2,0,5,0,1,11
379786,1,0,1,0,3,0,1,6
1583421,0,1,1,0,4,0,0,6
206634,3,4,1,0,0,81,23,112
396555,0,0,0,0,0,0,0,0
1865505,0,0,0,0,0,0,0,0
317705,0,0,1,0,0,0,0,1
119784,3,5,1,0,13,27,13,62
451279,0,0,0,0,1,0,0,1
875034,0,0,0,0,0,0,0,0
120663,0,0,0,0,0,21,3,24
1179034,0,2,0,0,4,56,28,90
338094,0,0,3,0,2,0,0,5
181536,0,1,0,0,14,2,17,34
430308,0,26,0,0,9,158,62,255
295289,1,3,1,0,2,2,21,30
884224,1,7,1,0,4,44,23,80
455590,0,0,0,0,0,15,4,19
119223,0,0,0,0,0,0,0,0
421239,0,0,0,0,2,1,9,12
118883,0,5,0,0,5,0,2,12
1935859,0,0,3,0,3,0,0,6
165854,0,3,0,1,0,28,15,47
477080,1,0,0,0,15,0,10,26
3531824,0,2,0,0,0,0,8,10
1401152,0,2,0,0,2,0,4,8
209077,0,6,0,0,3,87,32,128
411477,1,0,6,0,6,0,0,13
462499,0,1,0,0,1,0,10,12
3172532,0,3,0,0,1,48,13,65
290332,1,26,0,0,46,145,111,329
1976009,0,0,0,0,5,0,2,7
499603,0,5,0,1,7,43,19,75
1450321,16,2,0,6,0,151,12,187
3168230,0,0,0,0,1,0,0,1
119592,2,0,1,0,1,1,3,8
397313,0,0,0,0,0,0,0,0
348836,0,0,0,0,7,1,6,14
1486834,0,0,2,0,0,1,23,26
1772925,0,0,0,0,0,0,2,2
2268016,0,5,0,0,7,147,64,223
129280,0,2,0,0,3,0,1,6
445620,0,1,0,0,0,0,1,2
413300,0,0,0,0,1,0,0,1
488120,1,1,2,0,2,9,6,21
196857,0,9,0,0,11,69,20,109
1483025,0,0,0,0,0,0,0,0
305711,0,1,2,0,3,0,4,10
3799694,1,3,1,0,5,96,30,136
944835,0,0,0,0,10,1,7,18
988595,1,2,3,0,0,0,9,15
2381111,2,2,2,0,0,2,1,9
383574,0,0,0,0,1,0,0,1
1673434,0,0,0,0,0,0,1,1
3319920,1,2,1,0,2,5,10,21
395699,0,0,0,0,0,0,0,0
809504,0,0,2,0,0,1,3,6
369436,0,5,2,0,5,0,3,15
329774,0,4,0,0,10,1,1,16
4972062,0,1,0,0,0,12,4,17
245686,1,1,10,0,7,1,6,26
119141,0,0,0,0,0,1,2,3
192614,0,4,1,0,4,0,14,23
243585,0,0,0,0,0,0,0,0
1600196,0,0,1,0,1,60,13,75
499549,1,4,3,0,9,0,10,27
386140,0,1,0,0,1,0,0,2
1308729,1,3,1,0,7,13,5,30
2125435,0,1,1,0,9,1,4,16
1210166,0,1,3,0,1,2,14,21
1637706,0,4,1,0,5,41,9,60
142192,0,2,0,0,2,24,23,51
765010,0,0,1,0,4,39,6,50
1608290,1,2,1,0,4,1,3,12
397065,0,1,1,0,17,6,7,32
120703,0,2,0,0,3,8,5,18
383010,0,0,0,0,0,0,0,0
810900,0,0,0,0,0,0,0,0
413895,0,0,1,0,0,0,0,1
208988,0,1,0,0,8,23,15,47
253754,0,0,0,0,3,0,0,3
189584,0,5,0,0,12,10,7,34
480025,21,0,0,5,0,276,16,318
293564,0,0,0,0,12,0,10,22
420293,9,4,0,0,8,74,20,115
1075747,0,0,0,0,1,0,0,1
1392170,0,0,0,0,5,1,0,6
2302755,1,1,0,0,4,43,13,62
127723,0,6,4,0,12,1,7,30
1084972,0,0,0,0,0,0,1,1
350261,2,4,3,0,19,2,8,38
2016940,0,0,0,0,2,0,0,2
1682180,0,2,1,0,0,1,4,8
1440292,0,0,1,0,0,32,5,38
349903,0,1,2,0,1,1,1,6
2637294,1,2,0,0,9,171,63,246
1698641,0,0,1,0,0,0,0,1
146336,1,4,0,0,5,13,9,32
337563,0,5,0,0,0,0,1,6
275022,0,1,1,0,5,0,0,7
1462769,0,0,0,0,0,0,0,0
3715320,0,0,0,0,3,5,8,16
2802144,0,2,1,0,3,117,37,160
253556,1,4,0,0,8,0,2,15
2243537,0,20,0,0,10,29,37,96
119381,1,1,1,0,9,14,4,30
1132626,0,2,0,0,0,45,6,53
119395,0,2,2,1,0,19,6,30
303361,0,2,0,0,2,11,6,21
1213644,1,11,4,0,9,4,9,38
1172570,0,5,0,0,11,15,4,35
390521,1,0,2,0,0,1,3,7
308208,1,4,0,0,0,0,4,9
3268458,0,0,2,0,0,0,4,6
373889,0,0,1,0,0,0,0,1
1190536,1,13,1,0,10,19,20,64
1951266,0,0,0,0,0,0,0,0
1032815,0,5,0,0,5,1,13,24
1426329,0,1,0,0,2,20,8,31
1515091,4,0,1,0,2,0,0,7
374102,0,0,0,0,6,16,5,27
298814,0,0,2,0,10,1,2,15
1540133,0,0,1,2,3,119,9,134
758794,0,0,2,0,6,0,8,16
779982,1,0,0,0,0,14,7,22
2490326,1,3,1,1,8,35,14,63
1964418,0,0,0,0,3,0,0,3
3882082,0,1,0,0,0,0,3,4
200720,0,0,0,0,2,0,0,2
443456,1,0,4,0,0,11,3,19
765429,0,0,0,0,10,100,25,135
477095,3,0,0,0,0,1,1,5
1023111,0,6,0,0,6,0,14,26
240462,0,0,0,0,5,0,0,5
1390411,1,0,0,0,5,1,0,7
190374,1,0,0,0,4,0,0,5
470705,2,9,1,0,10,64,28,114
1294688,0,0,0,0,0,3,6,9
1619029,0,0,0,0,3,2,0,5
421238,9,1,0,0,0,44,4,58
338526,0,0,0,0,4,0,0,4
324127,0,1,1,0,3,13,3,21
452598,0,0,0,0,0,0,0,0
289879,0,2,0,0,9,56,26,93
361309,3,5,2,1,17,34,15,77
271668,1,10,3,0,23,1,19,57
1366344,1,9,0,0,6,62,41,119
324133,1,2,0,0,2,2,2,9
1226774,1,2,3,2,2,164,31,205
437857,0,0,0,0,1,0,0,1
1053810,0,1,1,0,5,0,2,9
119791,1,1,0,0,5,19,11,37
240890,0,2,1,0,1,0,5,9
187393,0,0,0,0,9,0,0,9
1386703,0,2,0,0,7,2,43,54
1583420,0,2,0,0,1,1,1,5
171363,1,1,2,0,1,0,2,7
361862,2,3,1,0,3,40,14,63
397892,0,0,1,0,0,0,0,1
831887,2,3,2,0,22,0,0,29
1621039,0,0,0,0,0,0,0,0
469903,0,0,0,0,13,0,8,21
2726560,0,1,0,0,3,0,5,9
1235522,4,4,1,0,9,17,13,48
388795,1,6,1,0,19,27,12,66
2788710,1,8,1,3,9,130,52,204
1441952,2,1,0,0,2,1,0,6
479537,1,5,0,0,14,3,2,25
2883512,0,0,2,0,3,55,49,109
120879,0,0,0,0,1,26,3,30
327162,0,1,0,0,3,0,0,4
1103982,0,0,1,0,0,18,2,21
2370248,0,10,4,0,5,48,20,87
277027,0,1,1,0,7,1,0,10
120689,6,7,1,0,21,13,7,55
360201,1,0,1,0,4,1,18,25
119008,1,5,1,0,5,192,25,229
147612,1,0,1,1,0,21,5,29
816545,1,2,2,0,3,1,9,18
1798709,0,2,0,0,0,37,9,48
433416,0,0,0,0,0,0,2,2
368891,0,0,0,0,1,0,0,1
179098,4,1,1,0,10,3,15,34
1853739,0,1,0,0,2,33,4,40
949731,0,1,1,0,1,0,0,3
433400,0,8,2,0,5,0,8,23
434409,0,2,1,1,6,4,7,21
280491,23,0,0,0,0,55,8,86
370986,0,0,0,0,4,35,16,55
3774694,0,5,0,4,0,86,21,116
1555064,0,0,0,0,11,0,16,27
299117,1,1,1,0,1,20,10,34
316356,1,7,1,0,17,0,2,28
120890,0,8,1,1,9,32,18,69
297884,0,0,0,0,2,1,0,3
453451,0,0,0,0,3,0,0,3
405159,0,1,16,0,12,4,4,37
4550098,3,5,0,0,2,24,16,50
865556,0,1,0,0,1,0,3,5
120660,0,5,1,0,22,24,37,89
837562,0,0,0,0,0,0,0,0
1131729,5,0,1,0,3,25,2,36
3741834,0,0,0,0,0,0,0,0
138749,0,0,1,0,0,0,0,1
2321549,0,2,1,0,0,2,2,7
1431045,0,2,0,1,1,60,32,96
376105,0,0,0,0,0,0,0,0
2326554,0,0,0,0,0,0,0,0
421206,0,11,0,0,30,1,33,75
172495,0,1,0,0,0,0,1,2
1433108,1,0,0,0,6,2,4,13
2709768,0,0,0,0,0,0,0,0
462465,2,1,0,0,3,1,0,7
118880,1,7,0,0,13,41,44,106
1114740,0,0,0,0,0,0,0,0
1046947,0,0,0,0,0,0,11,11
1178665,1,4,0,0,15,17,17,54
285728,0,0,1,0,1,15,13,30
120338,6,3,0,0,19,1,13,42
3416532,0,0,0,0,1,0,0,1
243155,3,1,1,1,2,32,6,46
1231587,0,7,1,0,16,234,65,323
249478,0,2,1,0,6,1,6,16
432291,1,0,0,0,5,0,3,9
968264,0,1,0,0,7,0,2,10
393162,0,13,0,0,30,0,29,72
482546,1,0,0,0,1,0,0,2
454921,0,2,0,0,4,1,2,9
230030,1,1,0,0,6,0,2,10
329575,1,5,3,0,12,0,10,31
391198,0,0,0,0,1,0,0,1
473434,1,0,1,0,0,2,0,4
4046784,2,2,0,0,4,0,25,33
2382396,1,6,3,0,46,36,41,133
796366,2,0,0,0,8,0,1,11
780504,0,0,0,0,1,24,6,31
1233227,0,5,0,0,2,31,7,45
1234548,1,0,2,0,3,24,15,45
267626,0,0,0,0,0,0,1,1
1951264,0,1,0,0,1,0,2,4
1235124,2,0,0,0,0,0,0,2
914797,0,1,1,0,2,2,10,16
1302011,0,0,0,0,1,0,0,1
1298649,0,8,0,1,12,70,45,136
165710,2,6,4,0,5,75,39,131
1588173,0,1,0,0,0,1,6,8
2277860,0,0,0,0,0,0,0,0
244000,2,4,0,0,14,0,3,23
1596365,0,0,0,0,0,0,0,0
2404425,0,0,0,0,2,1,3,6
1568911,2,0,0,0,1,0,0,3
337978,2,4,0,0,13,0,25,44
144084,7,5,0,0,2,26,3,43
1038686,0,5,1,1,9,23,15,54
269347,0,0,0,0,2,3,6,11
335438,0,6,3,0,13,0,9,31
2369135,1,7,0,0,0,0,14,22
2094766,0,0,0,0,1,1,1,3
371246,0,0,0,0,6,1,2,9
119142,2,1,0,0,1,1,14,19
164181,0,1,1,0,8,20,16,46
217869,0,0,0,0,1,0,1,2
783233,1,0,0,0,0,18,1,20
278504,2,4,2,0,3,28,8,47
228333,0,2,0,0,4,27,16,49
314353,2,3,0,0,9,28,4,46
475290,0,1,0,0,5,0,0,6
1626146,2,1,1,0,0,13,6,23
1259571,0,0,2,0,4,0,0,6
2872462,0,6,1,1,4,27,25,64
1600195,0,1,0,0,1,1,9,12
3553442,2,2,1,4,7,84,34,134
1502712,0,0,1,0,2,0,10,13
2771200,0,0,1,0,2,0,0,3
285462,0,5,0,0,8,11,2,26
380268,0,0,2,0,2,0,3,7
181865,2,2,1,0,5,68,24,102
890870,0,4,0,0,1,64,6,75
200469,0,6,0,0,13,2,18,39
4425200,0,0,0,0,2,5,1,8
1261945,1,1,1,0,0,0,1,4
304141,0,1,0,0,2,0,0,3
323298,2,0,1,1,0,49,5,58
2172584,0,1,0,2,1,53,18,75
1598822,0,1,0,0,1,1,1,4
1446192,0,0,0,0,0,0,0,0
1743720,0,0,0,0,0,3,1,4
146309,5,3,1,0,11,2,9,31
168786,0,0,0,0,4,4,4,12
3717252,0,0,1,0,2,1,0,4
1210819,0,0,2,0,7,0,0,9
848228,1,0,1,0,3,0,0,5
1985949,0,0,0,0,0,0,0,0
119396,0,15,0,0,42,136,76,269
486655,0,0,0,0,2,0,0,2
317303,0,0,0,0,0,0,0,0
185183,1,0,3,0,5,0,0,9
1170358,0,0,0,0,0,0,0,0
416508,0,0,1,0,4,0,0,5
1219342,0,0,0,0,0,0,0,0
964517,1,2,1,0,1,153,33,191
127536,2,0,0,0,2,0,0,4
1951265,0,0,1,0,0,0,0,1
838283,0,2,3,0,5,53,33,96
277434,1,4,0,0,7,1,14,27
462504,2,1,4,0,10,1,14,32
338337,0,0,0,0,2,0,7,9
938283,0,0,0,0,0,0,0,0
309698,1,3,0,0,12,27,18,61
787524,0,0,0,0,4,0,0,4
1046173,3,2,1,0,7,0,4,17
462538,0,0,4,0,2,0,0,6
1091617,0,0,0,0,0,0,0,0
887883,0,2,1,0,2,68,21,94
1032751,0,0,1,0,10,0,4,15
118842,1,24,0,3,5,122,56,211
139654,0,14,0,0,7,77,70,168
451079,0,0,0,0,0,0,0,0
4178092,0,2,0,0,1,24,15,42
2935476,0,0,0,0,1,0,0,1
298744,0,1,1,0,5,19,3,29
162650,4,1,0,0,13,86,1,105
217505,13,4,0,0,9,6,2,34
839980,0,5,2,0,16,21,28,72
241025,0,0,0,0,4,0,0,4
1523483,0,1,1,0,0,48,12,62
230838,0,1,2,0,2,0,7,12
411475,0,3,0,1,1,71,8,84
970416,0,0,0,0,0,0,0,0
300051,0,1,0,0,8,1,29,39
401855,0,0,0,0,0,1,0,1
245280,0,0,0,0,0,0,0,0
118665,0,0,0,0,2,0,0,2
425061,0,3,2,0,6,0,2,13
463034,1,2,2,0,9,1,10,25
310281,0,0,3,0,2,0,0,5
1369706,0,2,0,0,2,1,0,5
266465,0,5,1,0,16,85,21,128
299658,4,3,0,0,8,0,7,22
3040964,0,0,0,0,0,0,0,0
1632708,0,0,0,0,6,28,36,70
120107,2,2,1,0,7,9,6,27
422295,0,0,0,0,2,3,0,5
338096,1,0,0,0,2,0,0,3
414055,2,2,0,0,1,0,0,5
120885,3,1,0,0,4,0,0,8
1055292,0,0,0,0,2,2,2,6
1216475,0,0,0,0,0,0,0,0
252501,3,1,0,0,1,0,1,6
1073241,0,1,0,1,6,28,11,47
120891,1,0,0,0,11,0,3,15
384806,1,0,1,0,9,6,2,19
455960,0,4,0,0,3,39,9,55
1441951,0,5,0,0,0,3,0,8
1560747,0,0,0,1,1,41,5,48
335559,0,1,0,0,1,0,2,4
166813,0,0,0,0,0,0,0,0
443680,2,1,2,0,4,0,2,11
369226,0,1,0,0,4,9,13,27
125971,7,1,0,0,2,53,32,95
1646987,1,0,0,0,0,0,0,1
363988,2,2,2,0,3,1,19,29
177789,0,0,0,0,6,0,0,6
410297,0,0,1,0,1,0,3,5
864835,0,0,0,0,0,0,0,0
879870,0,0,2,0,5,1,7,15
2042568,1,1,2,0,5,59,33,101
1179904,0,0,0,0,2,45,13,60
4062536,0,1,0,0,4,68,42,115
1258972,0,1,0,0,0,3,1,5
425210,2,1,1,0,3,30,9,46
2005151,0,2,1,0,0,166,54,223
889573,0,2,0,0,1,0,0,3
441796,0,6,2,0,9,1,17,35
881891,0,3,6,0,2,0,8,19
468489,0,1,0,0,1,30,17,49
1564585,0,1,0,0,4,1,6,12
207201,0,2,3,0,0,0,8,13
1569923,0,0,3,0,9,0,0,12
120148,3,0,0,0,1,1,9,14
250371,0,0,0,0,0,0,0,0
3416742,1,1,0,0,0,18,17,37
161100,0,1,0,0,18,17,26,62
4361050,0,2,1,0,0,0,0,3
2015381,2,1,2,0,3,0,3,11
4034228,0,2,1,1,4,80,14,102
1979388,0,0,0,0,0,0,0,0
186566,2,4,0,0,18,0,23,47
124879,4,0,0,0,2,0,8,14
1007028,0,7,0,0,5,214,58,284
465436,0,0,0,0,0,0,3,3
332047,1,1,1,0,1,0,2,6
2381941,0,2,1,0,6,79,26,114
120389,0,0,0,0,0,0,0,0
277296,1,0,0,0,0,0,0,1
293662,1,1,0,0,3,0,9,14
243655,0,0,0,0,5,22,10,37
450314,5,1,1,0,8,65,18,98
261392,2,33,0,0,8,198,60,301
367085,0,22,0,0,16,58,57,153
311113,0,0,1,0,10,1,0,12
316654,0,0,2,0,0,0,0,2
466856,0,6,1,0,19,1,12,39
267913,0,1,8,0,0,0,0,9
144814,1,3,0,0,1,11,16,32
287978,0,0,0,0,0,0,2,2
414387,0,0,0,0,0,0,0,0
1615065,2,3,0,0,5,104,30,144
1655441,0,0,0,0,2,0,1,3
897361,0,1,0,0,3,20,5,29
473308,1,1,1,0,11,1,1,16
479143,2,1,1,0,5,0,0,9
811138,1,5,4,0,14,1,4,29
1334260,0,0,0,0,0,0,0,0
404802,0,0,0,0,3,0,1,4
274166,1,0,0,0,2,0,0,3
119468,0,3,0,0,4,15,4,26
1334512,0,1,1,0,1,0,2,5
1185836,0,0,0,0,1,2,1,4
118789,0,0,1,0,5,35,12,53
436697,0,0,1,0,0,1,0,2
882977,0,2,1,0,10,0,15,28
2554274,0,0,1,0,1,1,1,4
280030,0,0,0,0,0,0,0,0
378947,0,0,0,0,3,0,0,3
407304,0,0,0,0,6,0,10,16
993846,1,9,2,3,9,559,94,677
1758830,0,10,1,2,9,100,20,142
240200,3,3,0,0,0,0,0,6
396652,0,0,0,0,0,0,0,0
1411250,1,3,1,0,5,68,17,95
427229,2,3,4,0,7,1,16,33
219822,1,3,0,1,0,13,2,20
892769,0,0,0,0,0,0,0,0
492486,0,3,0,0,0,54,13,70
795351,0,0,0,0,0,1,4,5
118548,2,4,1,0,5,4,7,23
3813310,0,5,6,0,3,18,21,53
1538403,0,0,0,0,1,0,0,1
158622,0,0,1,0,1,0,0,2
268995,0,0,2,0,9,0,2,13
251127,0,1,1,0,8,0,36,46
247745,0,3,4,0,26,59,44,136
387575,0,3,1,0,2,18,11,35
1183923,0,0,0,0,10,52,9,71
1542344,0,0,0,0,0,6,4,10
120772,0,1,0,0,5,22,8,36
158811,0,0,0,0,0,0,0,0
1922777,0,0,0,0,1,2,7,10
429589,0,0,1,0,0,0,0,1
892782,0,0,0,0,0,0,0,0
342167,0,6,2,0,3,1,7,19
167404,0,0,0,0,1,0,1,2
375912,7,1,1,0,1,155,13,178
342172,0,1,0,0,2,16,6,25
453556,0,0,0,0,0,0,0,0
163676,1,7,0,0,0,1,4,13
3205376,3,3,1,0,3,1,5,16
1473832,0,0,0,0,11,7,1,19
383060,0,0,0,0,0,0,0,0
304669,0,0,1,0,0,0,0,1
402057,0,2,0,1,0,9,8,20
412536,2,0,0,0,3,0,0,5
1379177,0,0,0,1,9,10,2,22
124298,0,5,2,0,10,2,5,24
317198,2,1,1,0,2,26,5,37
318283,0,0,0,0,0,0,0,0
159273,0,4,0,0,9,4,21,38
3850214,0,16,0,0,12,130,119,277
436331,0,0,2,0,0,25,15,42
1904996,0,5,0,0,6,72,8,91
905372,0,0,0,0,6,2,6,14
199725,0,3,0,0,20,1,7,31
119643,0,2,1,0,7,1,8,19
1431181,3,1,1,0,0,3,5,13
465580,0,1,5,0,2,1,6,15
1284575,0,2,0,0,8,37,10,57
1033575,0,4,1,0,6,24,12,47
298130,0,2,3,0,5,1,8,19
2241351,1,8,0,0,27,88,32,156
1291150,0,0,0,0,1,0,1,2
1591479,0,0,0,0,5,14,11,30
480242,0,1,0,0,1,0,0,2
1124035,0,0,2,0,5,51,25,83
146838,0,14,1,0,22,74,42,153
3077214,0,1,1,0,3,1,0,6
829459,1,0,0,0,0,15,6,22
1341167,2,0,0,0,0,61,13,76
838232,0,0,1,0,0,0,0,1
1265990,0,4,0,0,3,0,11,18
2025690,0,0,0,0,0,0,0,0
1703148,0,1,0,0,0,11,1,13
211933,0,2,0,0,4,28,17,51
2023587,0,1,1,0,0,2,4,8
1243957,1,0,0,0,1,1,2,5
279331,2,8,0,0,16,122,63,211
498380,0,0,0,0,7,0,2,9
2355495,0,0,0,0,4,1,8,13
318081,1,1,1,0,2,0,1,6
5247022,0,0,0,0,6,4,3,13
173840,0,1,0,0,4,0,2,7
268200,0,0,1,0,0,0,0,1
376994,0,2,0,0,1,0,0,3
2167266,2,1,0,0,0,5,1,9
804497,0,1,1,0,0,1,3,6
407265,0,1,0,0,3,15,13,32
824747,1,2,1,0,11,3,2,20
138510,2,2,0,0,3,15,21,43
269095,1,1,1,0,1,40,16,60
160009,0,2,0,0,6,14,10,32
912593,0,0,0,0,0,0,1,1
120363,0,0,0,0,0,0,0,0
978762,0,0,0,0,1,0,0,1
4302938,0,0,0,0,0,0,0,0
4731136,0,0,1,0,1,2,0,4
144168,3,1,1,0,5,1,9,20
790604,0,0,1,0,1,0,0,2
118617,0,0,0,0,0,0,0,0
272338,0,0,3,0,1,25,3,32
1007029,1,0,0,0,2,0,0,3
363547,0,0,1,0,0,13,4,18
1532503,0,0,0,0,0,14,0,14
326769,0,4,0,0,18,1,21,44
340163,1,4,0,0,5,63,36,109
2975578,2,12,2,0,1,40,20,77
1860357,0,0,0,2,1,0,29,32
1277953,0,0,0,0,0,0,0,0
765128,0,0,0,0,0,0,0,0
1155592,0,0,0,0,0,0,0,0
303714,0,2,1,0,19,2,11,35
1051904,0,0,0,0,0,0,0,0
365485,1,1,0,0,2,29,14,47
1327194,0,0,0,0,3,0,7,10
486551,6,7,4,0,10,36,11,74
446013,1,3,0,0,1,0,0,5
1232200,0,3,0,0,5,175,46,229
155267,1,3,2,0,8,4,9,27
303933,0,1,1,0,11,0,13,26
374563,1,0,0,0,2,26,11,40
1727388,1,1,2,0,2,1,9,16
1031969,0,0,3,0,2,0,3,8
325710,3,2,1,0,3,0,1,10
1092026,4,8,1,0,3,46,33,95
119051,0,5,1,0,5,13,18,42
432021,0,6,0,0,7,1,6,20
1606378,1,0,1,0,11,19,21,53
449487,1,1,1,0,0,0,3,6
480687,1,2,1,0,1,14,15,34
884732,1,13,0,0,17,72,70,173
137386,0,2,0,0,3,22,11,38
1877832,0,0,1,0,4,2,7,14
164912,0,0,0,0,2,0,0,2
306685,0,3,0,0,6,41,39,89
120188,0,3,0,0,6,51,29,89
120611,0,8,0,0,7,45,5,65
1409024,1,0,0,0,11,0,5,17
396269,0,4,0,0,16,26,16,62
251736,1,5,4,0,18,52,24,104
452702,0,11,0,0,6,40,10,67
1586265,1,3,2,0,3,1,25,35
1972779,0,1,0,0,4,1,7,13
120177,0,2,4,0,6,0,0,12
119906,1,4,0,0,5,76,11,97
123324,0,8,0,0,16,29,43,96
299172,0,0,0,0,0,0,0,0
138704,3,0,0,0,5,9,5,22
327850,1,3,0,0,3,0,12,19
403217,0,0,1,0,1,18,4,24
2884018,0,0,1,0,6,0,0,7
172396,0,0,0,0,1,0,0,1
1371111,1,2,0,1,3,20,5,32
1193138,0,0,1,0,0,20,9,30
370263,0,1,0,0,1,1,7,10
454824,1,0,0,0,4,0,1,6
1647668,0,0,3,0,1,0,0,4
284490,0,4,2,0,3,1,36,46
398913,0,1,0,0,0,0,3,4
2387499,0,0,0,0,5,1,10,16
118615,1,1,0,0,5,1,4,12
3553976,0,2,0,0,4,19,2,27
1144884,0,1,1,0,6,15,15,38
1645080,0,1,1,0,0,1,6,9
270288,1,0,0,0,4,56,14,75
309987,1,3,1,0,0,10,6,21
438097,0,0,2,0,1,0,0,3
2473794,0,1,1,0,8,0,0,10
3787590,0,3,0,1,3,96,20,123
340377,0,0,0,0,2,19,16,37
3612616,0,22,0,3,13,107,43,188
118749,1,10,0,0,9,122,29,171
1655442,0,0,0,0,1,0,0,1
400497,0,0,0,0,0,0,0,0
3605418,0,7,0,1,3,111,11,133
1323045,0,1,0,0,4,21,37,63
490084,0,0,0,0,3,0,0,3
804522,0,1,0,0,3,9,0,13
2582802,0,2,0,1,3,84,16,106
1124037,0,0,0,0,6,0,1,7
1059786,0,0,1,0,0,0,0,1
1288403,0,0,0,0,1,6,3,10
484740,0,0,0,0,2,1,0,3
3165612,0,0,0,0,2,63,27,92
1490017,0,0,1,0,0,0,0,1
2528814,0,0,0,0,0,0,0,0
416236,0,0,0,0,0,0,0,0
466909,0,0,0,0,2,2,0,4
120201,1,0,1,0,4,1,5,12
489270,0,8,0,1,4,41,3,57
365929,0,3,1,0,6,5,5,20
3722070,0,3,0,0,0,4,4,11
857191,0,0,0,0,0,2,3,5
289765,2,3,0,0,7,6,4,22
337921,1,9,1,0,7,1,45,64
1037705,1,1,0,0,1,14,7,24
419887,0,0,0,0,0,3,0,3
427969,0,6,0,1,15,16,12,50
454987,1,4,2,0,12,20,46,85
266987,0,0,0,0,2,16,6,24
2096672,1,2,6,0,1,1,5,16
1055369,0,4,4,0,2,1,5,16
420223,0,1,3,0,6,1,0,11
469623,0,0,0,1,0,1,3,5
208092,12,0,1,3,1,132,9,158
1684233,0,1,0,0,0,45,6,52
1872194,1,1,0,0,13,30,17,62
489099,1,0,0,0,2,0,2,5
1694020,0,0,0,0,1,1,10,12
816442,0,0,2,0,0,0,0,2
1650062,0,2,1,0,3,1,17,24
437777,0,1,0,0,1,0,8,10
814255,1,0,0,0,0,0,1,2
366777,1,0,0,0,0,1,0,2
477347,0,0,0,0,0,0,1,1
1034032,1,6,0,0,9,39,20,75
871426,0,2,1,0,3,0,4,10
407887,4,1,0,5,6,258,25,299
1133985,2,3,0,0,2,0,1,8
3300542,1,1,0,0,4,26,6,38
390022,1,0,0,0,15,0,8,24
947802,1,5,1,0,14,2,29,52
467197,0,3,0,0,2,1,8,14
408236,0,0,1,0,0,0,2,3
1692486,0,5,3,0,2,13,25,48
246464,0,6,4,0,13,0,23,46
195685,0,2,1,0,13,21,14,51
240772,1,0,0,0,6,2,7,16
315983,0,1,0,0,5,13,4,23
2109184,0,1,0,0,1,22,9,33
120764,0,0,0,0,2,0,0,2
379865,0,0,0,0,9,0,4,13
1788391,2,0,0,4,0,108,7,121
305206,1,2,5,0,8,6,17,39
120770,1,1,1,0,0,2,2,7
1478964,0,1,0,0,0,56,27,84
402901,1,3,0,0,5,0,19,28
377109,0,0,1,0,2,1,0,4
1872181,0,0,0,0,2,0,0,2
119668,0,12,0,0,12,11,10,45
496806,0,2,3,0,3,0,8,16
1303828,0,0,0,0,2,39,16,57
795421,0,0,1,0,0,0,0,1
2096673,0,0,0,0,0,0,0,0
3766394,0,0,0,0,1,14,8,23
119640,0,1,3,0,3,0,1,8
1462041,0,0,0,0,5,1,4,10
119654,1,0,1,0,16,0,11,29
1078588,0,3,0,0,4,2,5,14
1152836,3,2,0,0,11,1,2,19
133240,0,0,0,0,0,0,0,0
409459,4,4,1,0,17,22,7,55
1321860,0,1,1,0,3,1,9,15
382625,2,0,0,0,0,0,4,6
1152822,0,0,0,0,0,0,1,1
1185834,0,0,2,0,1,0,0,3
2763304,5,0,0,26,0,148,13,192
257756,1,2,0,0,3,0,8,14
328828,0,7,3,0,7,65,41,123
361596,1,0,2,0,2,2,1,8
1727770,1,7,0,0,3,16,23,50
2076220,0,0,0,0,0,1,1,2
343737,1,0,0,0,0,5,2,8
480255,0,6,1,0,6,1,23,37
1385867,0,8,0,0,10,99,41,158
408790,0,1,0,0,0,0,3,4
454945,0,0,3,0,1,0,0,4
285823,0,0,0,0,5,19,4,28
840361,1,3,0,2,6,144,17,173
371746,1,2,1,0,1,0,0,5
1403865,1,3,0,0,8,0,0,12
808331,0,1,0,0,6,11,3,21
1099212,0,0,0,0,0,0,0,0
119324,0,0,0,0,3,3,0,6
360139,0,0,1,0,5,0,3,9
366548,0,0,0,0,0,0,0,0
1130080,0,0,1,0,2,9,7,19
1300851,3,9,9,3,9,40,40,113
2918436,0,1,0,0,4,0,24,29
128853,1,1,0,0,3,0,1,6
149261,0,3,1,0,11,3,2,20
1335975,0,0,0,0,0,0,0,0
1634122,0,0,0,0,0,0,0,0
1433811,0,4,1,0,2,60,18,85
301470,0,2,0,0,8,49,18,77
980970,0,0,0,0,0,0,0,0
252028,0,1,3,0,0,0,6,10
1790864,1,1,0,0,4,0,8,14
1907668,0,3,2,0,11,52,29,97
360717,0,0,3,0,7,0,0,10
1972591,5,0,0,0,0,2,1,8
2140619,0,2,0,0,0,32,21,55
410097,1,51,0,0,25,146,138,361
129387,1,5,3,0,6,44,29,88
971209,1,4,4,0,5,29,25,68
1616195,0,0,0,0,0,1,0,1
443632,0,0,0,0,9,0,4,13
200550,0,4,0,0,5,0,3,12
475394,0,21,2,0,16,133,58,230
1606392,0,0,12,0,4,18,41,75
236784,0,0,2,1,0,23,18,44
415306,1,10,3,0,15,2,7,38
164052,1,3,0,0,14,42,21,81
120176,0,0,0,0,1,0,0,1
172156,0,10,1,0,27,137,129,304
120604,1,0,0,0,7,1,1,10
329101,1,11,0,0,8,40,25,85
190138,0,2,1,0,5,1,3,12
2461150,0,0,1,0,4,2,3,10
1230414,0,1,0,0,0,0,1,2
120823,3,1,0,0,1,5,2,12
1591095,0,2,1,0,2,1,0,6
398286,0,0,0,0,0,0,0,0
247196,0,1,0,0,0,0,0,1
963194,0,2,0,1,2,9,1,15
2975590,0,2,0,0,4,0,1,7
335266,0,0,1,0,1,0,2,4
164085,0,1,2,0,5,13,13,34
1291580,0,1,0,0,2,31,11,45
800369,0,0,0,0,1,0,0,1
2140379,2,2,0,0,3,1,7,15
1232207,0,0,2,0,2,3,2,9
2103254,0,3,1,0,10,23,67,104
2401878,0,4,0,0,5,40,5,54
1321509,6,2,2,0,32,41,66,149
2053463,0,0,0,0,2,16,5,23
366174,0,6,0,0,8,1,32,47
1568346,0,0,2,0,0,10,3,15
315824,2,4,1,0,4,1,16,28
2891174,0,1,1,0,8,63,19,92
1291584,5,3,1,0,5,1,13,28
1126590,0,2,0,0,2,1,6,11
817177,0,0,2,0,1,0,2,5
1464540,0,1,2,0,0,0,9,12
1333125,1,9,3,2,8,72,32,127
292963,0,1,1,0,10,81,24,117
325703,0,0,0,0,0,0,1,1
274558,0,0,0,0,1,1,2,4
225071,0,7,0,1,6,27,11,52
448011,0,0,0,0,4,0,4,8
472399,1,0,0,0,6,2,0,9
234829,0,2,1,0,6,1,9,19
1454468,0,1,0,0,5,2,6,14
3416744,0,0,4,0,0,21,13,38
332280,1,2,2,0,9,0,0,14
119081,1,0,3,0,1,20,18,43
377092,0,15,2,0,4,0,0,21
211465,2,4,1,0,4,78,15,104
976238,0,0,0,0,0,0,0,0
119095,0,0,0,0,1,0,0,1
1753383,0,0,0,0,0,0,0,0
466893,0,1,0,4,1,27,10,43
3470600,0,0,0,0,0,0,0,0
430357,0,1,1,0,1,18,9,30
1386588,2,2,1,0,4,1,5,15
2180411,0,0,0,0,0,0,0,0
380817,0,0,1,0,0,18,8,27
365125,0,1,2,1,3,19,3,29
160797,0,1,1,0,16,24,19,61
1078188,2,0,0,2,1,63,21,89
2238050,0,0,1,0,2,50,15,68
256276,0,0,0,0,1,0,2,3
1408101,5,3,0,0,12,0,3,23
307987,1,10,0,0,23,157,74,265
212346,0,1,1,0,8,0,2,12
124102,4,7,0,0,4,12,10,37
343135,1,2,4,0,7,1,10,25
358273,0,2,0,0,6,1,2,11
419706,0,4,0,0,18,24,44,90
1502404,0,15,0,0,7,73,15,110
2398231,1,8,1,0,19,0,3,32
1778304,0,0,5,0,1,23,12,41
343121,0,13,0,0,6,27,22,68
4139124,0,19,0,0,17,133,73,242
800027,0,4,1,1,7,11,10,34
227538,0,0,0,0,0,0,1,1
844671,0,16,1,0,5,94,42,158
862846,8,0,1,0,7,15,19,50
449086,0,0,0,0,0,0,0,0
367652,2,14,0,1,10,4,10,41
1840309,0,2,0,0,0,0,0,2
365737,0,0,1,0,4,19,4,28
316732,0,1,0,0,31,0,9,41
1093908,0,1,0,0,1,0,0,2
399201,0,2,0,0,2,1,5,10
356470,0,0,0,0,1,0,0,1
816692,0,1,0,0,3,2,7,13
279493,0,6,1,0,25,1,13,46
1321870,4,11,0,1,21,20,13,70
838221,0,0,0,0,1,0,0,1
1931533,6,7,0,5,2,96,19,135
205000,1,7,3,0,4,0,8,23
120576,0,1,0,0,3,0,2,6
427944,1,2,0,0,5,21,7,36
164334,0,2,0,0,2,6,2,12
265086,0,3,0,0,10,39,19,71
401997,0,0,2,0,1,1,5,9
157503,0,5,10,0,15,2,12,44
369441,3,3,1,0,4,1,2,14
4669986,0,0,0,0,0,0,0,0
2361509,0,2,0,0,0,1,0,3
329717,1,9,3,0,13,2,33,61
1095174,0,2,7,0,8,0,2,19
118566,3,1,1,0,4,4,2,15
963966,0,0,0,0,0,0,0,0
1535109,0,0,0,0,2,0,4,6
411951,0,0,0,0,5,0,7,12
2273657,0,0,0,0,0,9,4,13
988045,0,0,0,0,2,0,0,2
404390,2,10,0,3,9,342,55,421
192111,2,0,2,0,3,0,4,11
1457767,0,0,0,0,2,0,0,2
results.csv,1,1,1,1,1,1,1,7
1136608,1,0,1,0,0,88,7,97
1630036,0,0,0,0,0,0,0,0
133046,1,4,0,0,1,1,12,19
1521197,4,0,0,0,1,0,0,5
134067,0,0,0,0,0,0,0,0
268978,1,1,0,0,3,0,4,9
975645,0,0,1,0,2,0,0,3
1726669,5,9,0,0,25,38,22,99
391304,0,0,0,0,0,0,2,2
250202,0,2,1,0,6,37,22,68
246460,0,1,0,0,0,0,0,1
1285309,1,3,0,0,2,11,8,25
1815862,0,0,0,0,2,0,0,2
309377,1,6,4,0,4,8,17,40
418753,0,0,0,1,1,4,5,11
183790,1,1,0,0,4,0,2,8
2310332,2,0,0,0,0,0,0,2
119123,3,2,0,0,7,5,17,34
3640424,0,0,0,0,4,17,1,22
1535108,0,1,0,0,2,68,13,84
119137,0,0,0,0,2,0,0,2
333766,0,3,2,0,1,52,28,86
280590,0,1,1,0,4,1,16,23
324554,0,0,1,0,2,1,16,20
367479,3,6,1,0,8,1,11,30
264616,0,2,0,0,6,6,2,16
402910,0,3,1,0,0,19,11,34
145660,16,3,5,0,5,0,4,33
457939,0,1,0,0,0,1,1,3
1850457,0,11,3,1,12,63,53,143
350028,0,2,0,0,2,0,2,6
2713180,4,4,0,0,19,171,26,224
2364841,1,0,3,0,0,91,29,124
1664894,0,0,2,0,0,0,0,2
118956,1,7,1,0,9,5,21,44
238380,0,0,0,0,3,1,2,6
2967224,0,1,0,0,6,0,4,11
248667,0,1,0,0,5,6,1,13
120577,3,1,0,0,1,14,12,31
3659388,0,0,0,0,3,4,9,16
1559549,1,5,0,0,4,73,14,97
1074638,0,1,1,0,2,1,5,10
323944,0,0,1,0,3,2,7,13
799949,1,25,0,0,2,13,16,57
384537,0,0,0,0,6,6,3,15
138304,0,0,0,0,2,9,6,17
1126618,2,2,4,0,4,1,14,27
1617661,0,0,4,0,7,0,6,17
1300854,0,1,2,0,6,0,0,9
841046,3,2,1,2,7,22,18,55
901476,0,3,0,0,3,0,0,6
780571,0,0,2,0,4,31,3,40
3569230,3,1,1,14,0,178,4,201
384286,1,5,1,0,1,1,0,9
118771,0,7,0,0,10,18,16,51
465551,1,3,1,1,0,15,4,25
1191111,1,5,0,2,0,77,28,113
345551,0,5,1,1,6,32,6,51
765476,0,0,1,0,0,0,0,1
2345737,0,1,0,1,7,41,4,54
3522806,2,2,0,0,3,10,3,20
404030,0,8,0,0,1,1,5,15
482527,0,8,3,0,6,0,8,25
978764,0,2,0,0,4,0,5,11
119282,0,0,0,0,0,0,0,0
1821641,0,0,5,0,0,15,3,23
1389137,0,1,0,0,2,0,5,8
221799,0,0,0,0,0,0,0,0
1307068,0,0,0,0,1,14,8,23
497116,0,0,0,0,1,0,0,1
434124,2,0,1,0,0,1,1,5
2582782,4,12,0,0,12,33,19,80
408839,0,3,2,1,6,13,15,40
464049,0,0,1,1,0,27,9,38
1232776,0,4,0,4,0,34,6,48
155711,2,19,0,3,6,139,27,196
1103275,0,0,0,0,1,31,6,38
1095217,0,1,0,1,1,97,43,143
1825157,0,0,1,0,1,17,1,20
124315,1,0,0,0,3,0,0,4
119094,1,1,0,0,8,29,14,53
120601,2,1,0,2,7,17,12,41
1179056,2,2,0,0,1,15,7,27
291502,0,5,0,0,0,29,1,35
446029,0,6,1,0,1,0,4,12
320691,0,2,0,0,0,3,5,10
1622547,0,12,1,0,7,195,66,281
405676,10,4,0,0,4,0,0,18
1139328,1,0,2,0,2,2,11,18
119731,0,2,0,0,2,2,9,15
880578,0,0,0,0,1,6,8,15
1646980,1,1,0,0,7,1,8,18
3195644,0,2,0,0,1,1,0,4
1126591,0,2,2,0,8,1,9,22
469021,3,0,1,0,2,14,16,36
263757,0,1,0,0,2,0,1,4
1045778,1,2,1,0,2,3,11,20
134847,0,0,0,0,3,26,6,35
780607,0,5,0,0,4,53,6,68
120832,0,4,0,0,2,2,22,30
1399683,0,1,1,0,3,9,17,31
1226273,2,1,0,0,1,32,8,44
1956620,0,2,0,1,2,72,26,103
421073,1,2,0,0,10,0,2,15
280380,0,3,1,0,2,41,8,55
421715,3,0,3,0,6,2,4,18
375679,0,2,0,0,5,80,15,102
310793,1,0,2,0,1,4,3,11
379725,0,0,0,0,2,1,0,3
384680,0,1,2,2,2,54,12,73
948470,0,0,0,0,1,0,0,1
2059171,1,1,0,0,1,24,7,34
805564,0,0,1,0,2,0,0,3
338751,3,7,2,0,41,1,6,60
421729,1,0,1,0,10,0,1,13
1640459,3,6,0,0,8,121,16,154
805570,0,1,0,0,2,13,3,19
1197628,0,6,1,0,5,117,27,156
1860353,0,0,0,0,0,0,0,0
331952,0,0,0,0,2,2,3,7
762125,0,0,0,0,0,0,0,0
963178,1,1,0,0,0,11,11,24
4572514,2,6,2,0,4,43,41,98
1053859,0,1,0,0,2,6,4,13
3065204,0,1,0,0,6,0,1,8
1464580,0,4,0,0,2,25,8,39
377091,0,3,2,1,0,47,15,68
381061,2,1,0,0,3,0,0,6
381707,1,6,3,0,10,0,5,25
1060277,0,0,1,0,3,0,41,45
2017020,0,0,0,0,0,0,0,0
420609,1,3,0,0,1,22,10,37
406816,0,0,0,0,5,1,4,10
478304,0,0,0,0,0,0,0,0
1229340,2,8,3,1,20,3,20,57
457495,0,0,0,0,0,0,0,0
118607,0,0,1,0,0,0,0,1
790628,1,3,1,0,4,1,8,18
1675192,0,1,0,0,7,6,10,24
351283,0,0,0,0,0,0,0,0
2080374,0,1,0,0,2,23,9,35
4630562,0,5,0,0,12,1,20,38
2245084,0,0,0,0,0,0,0,0
2870612,0,0,0,0,1,59,40,100
200027,0,1,0,0,1,0,4,6
472198,2,24,0,0,18,165,110,319
483607,5,2,1,0,0,61,17,86
492044,0,0,0,0,0,0,0,0
404032,0,1,0,0,0,0,1,2
1235796,1,0,0,0,0,1,4,6
2402157,0,1,0,0,4,22,6,33
1413495,1,0,0,0,2,1,6,10
1438176,0,1,3,0,5,50,40,99
3270538,0,0,0,0,0,0,0,0
1623288,0,0,0,0,4,0,0,4
1341188,1,0,1,0,3,2,4,11
388482,1,3,0,0,0,1,7,12
1397280,1,0,0,0,1,0,7,9
338427,0,0,0,0,0,1,1,2
462200,0,3,1,0,23,40,41,108
4160708,1,5,0,0,0,44,8,58
271027,2,3,1,0,1,18,9,34
841044,0,0,2,0,3,1,6,12
443543,0,0,0,0,1,0,0,1
450259,5,0,0,0,5,21,19,50
365907,1,4,0,1,3,41,20,70
209163,0,0,0,0,1,0,0,1
498353,0,0,0,0,5,1,5,11
118798,0,5,3,0,16,83,26,133
2910904,4,4,0,0,0,3,2,13
1667353,0,0,2,0,0,0,0,2
2436386,0,5,2,0,2,2,65,76
118954,2,4,0,2,2,39,11,60
3416828,0,0,0,0,0,0,0,0
332452,0,1,0,0,1,0,0,2
1185416,0,0,1,0,5,0,0,6
471042,0,14,0,0,7,0,47,68
118571,3,1,0,0,7,2,3,16
795368,3,0,2,0,2,39,26,72
275719,0,1,1,0,0,27,13,42
1182345,1,0,1,0,5,35,8,50
1605717,0,0,0,2,0,56,17,75
947810,0,1,0,0,6,1,2,10
306734,1,1,1,0,0,0,2,5
810784,0,0,0,0,1,0,0,1
2994190,0,3,0,0,4,49,35,91
775539,0,3,0,0,8,0,2,13
458413,2,1,0,0,0,19,6,28
1172049,0,0,0,0,3,32,13,48
1706593,0,5,6,0,5,0,62,78
1205537,0,1,0,0,4,1,5,11
388125,0,7,0,0,2,0,10,19
1549572,0,0,0,0,0,0,0,0
387564,6,2,1,0,2,19,13,43
162222,0,0,0,0,1,0,1,2
270846,0,0,0,0,0,0,0,0
1306980,0,1,0,1,0,63,25,90
120777,2,4,3,0,7,31,15,62
424095,0,0,1,0,0,0,0,1
120762,0,0,0,0,0,0,0,0
120004,0,1,1,0,8,11,13,34
1294213,0,0,4,0,1,15,12,32
306047,0,14,0,0,13,1,23,51
1152398,0,3,1,0,1,0,5,10
489049,4,16,2,0,12,0,19,53
314331,0,1,4,0,1,12,7,25
2719848,0,0,0,0,0,0,0,0
1263670,1,3,2,0,14,15,9,44
988047,0,1,1,0,0,1,12,15
145893,0,0,0,0,0,0,0,0
362270,1,5,3,0,20,15,20,64
118570,0,0,0,0,0,0,0,0
133093,0,0,3,0,6,0,22,31
844471,0,0,2,0,0,0,0,2
118564,5,10,0,0,33,31,19,98
2671706,0,0,2,0,4,1,1,8
2312718,0,6,1,0,15,140,34,196
935075,0,0,0,0,2,1,1,4
866439,0,1,1,0,1,1,7,11
165982,0,0,0,0,0,0,0,0
258463,1,0,0,0,5,2,4,12
134273,0,4,0,0,2,53,13,72
1727776,0,4,1,0,5,62,57,129
289992,0,0,1,0,10,18,12,41
1020530,3,11,1,0,0,123,22,160
144964,0,0,0,0,2,2,4,8
1302067,0,0,2,0,0,0,0,2
993842,0,0,0,0,1,1,3,5
1244754,0,7,0,0,11,60,17,95
231402,0,3,1,0,0,0,5,9
1554091,2,8,0,0,2,1,8,21
180073,0,1,0,0,3,9,1,14
1078940,0,1,2,0,5,0,9,17
1043726,0,0,0,0,2,0,0,2
322330,0,0,0,0,0,0,0,0
465234,0,0,0,0,0,0,0,0
419843,0,0,1,0,1,1,12,15
1878870,0,1,2,0,2,16,19,40
763831,1,1,4,0,6,0,16,28
462229,0,2,0,0,25,0,13,40
2334873,0,0,1,0,2,3,1,7
1935179,0,6,1,0,7,0,29,43
1288558,0,5,0,1,1,41,14,62
186589,1,3,1,0,5,0,3,13
2194499,1,0,0,0,2,5,5,13
387808,0,1,1,0,15,12,46,75
1228705,0,0,0,0,0,0,0,0
238546,0,0,0,0,1,0,0,1
470765,0,0,1,0,0,1,0,2
3289956,0,0,0,0,2,9,5,16
478311,1,7,1,1,2,129,57,198
120399,3,10,0,0,3,42,9,67
1659337,0,3,0,0,3,1,13,20
442933,1,0,0,0,3,0,0,4
841119,0,0,0,0,0,0,0,0
390384,0,0,1,0,0,0,0,1
4263482,0,1,0,0,7,0,0,8
1220198,0,0,0,0,2,0,1,3
308644,0,0,2,0,0,0,1,3
1440345,1,2,1,0,0,11,14,29
120616,3,1,0,0,9,0,0,13
377084,0,0,0,0,0,1,0,1
1491044,0,7,1,1,3,132,22,166
1179069,0,0,0,0,3,1,10,14
384642,0,0,0,0,0,0,0,0
290145,0,1,2,0,0,12,6,21
2103281,0,3,0,0,0,1,6,10
359423,0,0,0,0,0,8,8,16
331953,0,4,1,0,13,46,38,102
300556,2,5,1,0,3,0,12,23
499448,0,0,0,0,0,0,0,0
497465,0,0,0,0,4,0,6,10
408345,0,0,0,0,7,1,14,22
2267998,1,12,1,4,1,55,10,84
2261331,6,0,1,0,4,103,29,143
1436562,0,0,0,0,0,0,0,0
486583,0,0,0,0,0,0,0,0
326208,8,1,0,0,6,48,10,73
119054,0,2,1,0,1,1,0,5
424136,0,3,2,0,2,21,2,30
2184339,0,2,0,0,2,6,5,15
264761,0,0,1,0,2,9,8,20
196229,0,1,3,0,7,0,8,19
2101441,0,20,0,0,7,133,36,196
465624,2,2,1,0,4,0,7,16
253867,0,8,4,0,6,14,16,48
435761,0,0,0,0,0,0,0,0